abaissement	[n.m] - recessione [n]
abaisser	[vblex] - abbassare [vblex]
abandon	[n] - abbandono [n]
abandonner	[vblex] - abbandonare [vblex]
abattement	[n] - abbattimento [n.m]
abattre	[vblex] - abbattere [vblex]
abattre	[vblex] - sconfiggere [vblex]
abbaye	[n] - abbazia [n.f]
abbé	[n] - abate [n.m]
abdiquer	[vblex] - abdicare [vblex]
abdomen	[n] - pancia [n.f]
abeille	[n] - ape [n]
aberration	[n] - aberrazione [n]
ablation	[n] - ablazione [n]
abnégation	[n] - abnegazione [n]
abolition	[n] - abolizione [n]
abondance	[n] - abbondanza [n]
abondant	[adj.f] - abbondante [adj]
abondant	[adj.GD] - abbondante [adj]
abondant	[adj.m] - abbondante [adj]
abonder	[vblex] - abbondare [vblex]
abordage	[n] - abbordaggio [n]
aborigène	[n] - aborigeno [n.f]
abri	[n] - riparo [n]
abriter	[vblex] - cautelare [vblex]
abréger	[vblex] - abbreviare [vblex]
absence	[n] - assenza [n]
absentéisme	[n] - assenteismo [n]
absolu	[adj] - assoluto [adj]
absolument	[adv] - assolutamente [adv]
absolument pas	[adv] - assolutamente [adv]
absolution	[n] - assoluzione [n]
absolutisme	[n] - assolutismo [n]
absorbant	[adj.f] - assorbente [adj]
absorbant	[adj.GD] - assorbente [adj]
absorbant	[adj.m] - assorbente [adj]
absorbé	[adj] - assorto [adj]
absorption	[n] - assorbimento [n.m]
abstention	[n] - astensione [n]
abstinence	[n] - astinenza [n]
abstraction	[n] - astrazione [n]
abstrait	[adj] - astratto [adj]
absurde	[adj.mf] - assurdo [adj]
abus	[n.m.sp] - abuso [n]
abuser	[vblex] - abusare [vblex]
abîme	[n] - abisso [n]
académie	[n] - accademia [n]
académique	[adj.mf] - accademico [adj]
accent	[n] - accento [n]
acceptable	[adj] - accettabile [adj]
acceptation	[n] - accettazione [n]
accepter	[vblex] - accettare [vblex]
accessoire	[adj.mf] - accessorio [n]
accessoire	[n] - accessorio [n]
accident	[n] - incidente [n]
accidentel	[adj.f] - accidentale [adj]
accidentel	[adj.GD] - accidentale [adj]
accidentel	[adj.m] - accidentale [adj]
accidentellement	[adv] - accidentalmente [adv]
acclamation	[n] - acclamazione [n]
acclamer	[vblex] - acclamare [vblex]
acclimatation	[n] - acclimatazione [n]
acclimater	[vblex] - acclimatare [vblex]
accompagner	[vblex] - accompagnare [vblex]
accomplissement	[n] - compimento [n]
accord	[n] - accordo [n]
accord	[n] - conforme [adj]
accorder	[vblex] - accordare [vblex]
accorder	[vblex] - concedere [vblex]
accordéon	[n] - fisarmonica [n]
accordéoniste	[n] - fisarmonicista [n.GD.pl]
accotement	[n] - corsia di emergenza [n]
accouchement	[n] - parto [n]
accoutrement	[n.m] - abbigliamento [n]
accroissement	[n] - incremento [n]
accroître	[vblex] - incrementare [vblex]
accréditation	[n] - accreditamento [n.m]
accréditer	[vblex] - accreditare [vblex]
accumulation	[n] - cumulo [n.m]
accumuler	[vblex] - accumulare [vblex]
accuser	[vblex] - accusare [vblex]
accéder	[vblex] - accedere [vblex]
accélérateur	[adj] - acceleratore [adj]
accélérateur	[n] - acceleratore [adj]
accélération	[n] - accelerazione [n]
accélérer	[vblex] - accellerare [vblex]
achat	[n.m] - acquisto [n.m]
acheter	[vblex] - comprare [vblex]
acheteur	[n] - acquirente [n.mf]
achever	[vblex] - finire [vblex]
acide	[adj.mf] - acido [adj]
acide	[n] - acido [adj]
acier	[n] - acciaio [n]
acoustique	[adj.mf] - acustico [adj]
acoustique	[adj] - acustico [adj]
acoustique	[n] - acustica [n]
acoustiquement	[adv] - acusticamente [adv]
acquis	[n.m.sp] - esperienza [n]
acquisition	[n] - acquisto [n.m]
acquitter	[vblex] - assolvere [vblex]
acrobatie	[n] - acrobazia [n]
acroissement	[n.m] - ampliamento [n]
acte	[n.m.sg] - auto [n.sp.sp]
acte	[n.m] - atto [n.m]
acteur	[n] - attore [n]
actif	[adj] - attivo [adj]
actif	[n] - attivo [adj]
actif	[n] - avere [n]
action	[n.f.pl] - auto [n.sp.sp]
action	[n] - azione [n.mf]
actionnaire	[n] - azionista [n.f.pl]
activation	[n] - limite [n.m]
activement	[adv] - attivamente [adv]
activiste	[n] - attivista [n.f.pl]
activité	[n] - attività [n.f.sp]
actu	[n] - attualità [n.f.sp]
actualisation	[n] - aggiornamento [n.m]
actualiser	[vblex] - aggiornare [vblex]
actualité	[n] - attualità [n.f.sp]
actuel	[adj.f] - attuale [adj]
actuel	[adj.GD] - attuale [adj]
actuel	[adj.m] - attuale [adj]
actuel	[adj] - attuale [adj]
actuellement	[adv] - attualmente [adv]
adaptation	[n] - adeguamento [n.m]
adapter	[vblex] - adattare [vblex]
adapter	[vblex] - adeguare [vblex]
additif	[adj] - additivo [n]
additionnel	[adj.f] - supplementare [adj]
additionnel	[adj.GD] - supplementare [adj]
additionnel	[adj.m] - supplementare [adj]
additionnellement	[adv] - ulteriormente [adv]
adhésif	[adj] - adesivo [adj]
adhésion	[n] - adesione [n]
adieu	[n] - arrivederci [ij]
adjacent	[adj.f] - adiacente [adj]
adjacent	[adj.GD] - adiacente [adj]
adjacent	[adj.m] - adiacente [adj]
adjectif	[n] - aggettivo [n]
adjudication	[n] - allocazione [n]
admettre	[vblex] - ammettere [vblex]
administrateur	[n] - amministratore [n]
administratif	[adj] - amministrativo [adj]
administratif	[n] - amministrativo [adj]
administration	[n] - amministrazione [n]
administrer	[vblex] - amministrare [vblex]
admirable	[adj] - ammirabile [adj]
admiration	[n] - ammirazione [n]
admirer	[vblex] - ammirare [vblex]
adolescence	[n] - adolescenza [n]
adolescent	[n.f] - adolescente [adj]
adolescent	[n.GD] - adolescente [adj]
adolescent	[n.m] - adolescente [adj]
adonner	[vblex] - consacrare [vblex]
adopter	[vblex] - adottare [vblex]
adoption	[n] - adozione [n]
adorable	[adj] - adorabile [adj]
adoration	[n] - devozione [n]
adorer	[vblex] - adorare [vblex]
adosser	[vblex] - addossare [vblex]
adresse	[n] - direzione [n]
adresser	[vblex] - dirigere [vblex]
adroit	[adj.f] - abile [adj]
adroit	[adj.GD] - abile [adj]
adroit	[adj.m] - abile [adj]
adrénaline	[n] - adrenalina [n]
adulte	[n.mf] - adulto [n]
adultère	[n] - adulterio [n]
adverbe	[n] - avverbio [n]
adversaire	[n.mf] - avversario [n]
adversaire	[n.mf] - oppositore [n]
adverse	[adj.mf] - avverso [adj]
adéquatement	[adv] - adeguatamente [adv]
affable	[adj] - affabile [adj]
affaiblir	[vblex] - debilitare [vblex]
affaire	[n] - business [n]
affairer	[vblex] - agitare [vblex]
affamé	[adj] - affamato [adj]
affectif	[adj] - affettivo [adj]
affection	[n.f] - fine [n.mf]
affection	[n] - malattia [n]
affiche	[n.f] - poster [n]
afficher	[vblex] - annunciare [vblex]
affiliation	[n] - affiliazione [n]
affilier	[vblex] - affiliare [vblex]
affinité	[n] - affinità [n.f.sp]
affirmatif	[adj] - affermativo [adj]
affirmation	[n] - affermazione [n.f]
affirmer	[vblex] - affermare [vblex]
affliger	[vblex] - affliggere [vblex]
affluence	[n] - afflusso [n.m]
affluent	[n] - affluente [n]
affrontement	[n] - scontro [n]
affronter	[vblex] - affrontare [vblex]
affubler	[vblex] - vestire [vblex]
afin que	[cnjadv] - col fine di [cnjadv]
agence	[n] - agenzia [n]
aggravation	[n.f] - degradazione [n.f]
agile	[adj] - agile [adj]
agilité	[n] - agilità [n.f.sp]
agiter	[vblex] - agitare [vblex]
agneau	[n.m] - agnello [n]
agonie	[n] - agonia [n.f]
agoniser	[vblex] - agonizzare [vblex]
agrandissement	[n.m] - ampliamento [n]
agresser	[vblex] - aggredire [vblex]
agresseur	[n] - aggressore [n]
agressif	[adj] - aggressivo [adj]
agression	[n] - aggressione [n.f]
agressivité	[n] - aggressività [n.f.sp]
agricole	[adj] - agricolo [adj]
agriculteur	[n] - agricoltore [adj]
agriculture	[n] - agricoltura [n]
agréablement	[adv] - gratamente [adv]
agréer	[vblex] - accettare [vblex]
agrémenter	[vblex] - adornare [vblex]
aide	[n.f] - aiuto [n.m]
aider	[vblex] - aiutare [vblex]
aider	[vblex] - ausiliario [adj]
aigle	[n.mf] - aquila [n]
aiguille	[n.f] - ago [n.m]
aiguiller	[vblex] - orientare [vblex]
aiguisé	[adj] - affilato [adj]
ail	[n] - aglio [n]
aile	[n] - ala [n]
aimablement	[adv] - amabilmente [adv]
aimer	[vblex] - amare [vblex]
ainsi	[adv] - così [adv]
ainsi que	[cnjadv] - così come [adv]
air	[n] - aria [n.f]
aire	[n] - sfera [n]
aisance	[n] - facilità [n.f.sp]
aisselle	[n] - ascella [n]
aisé	[adj.f] - facile [adj]
aisé	[adj.m] - facile [adj]
aisément	[adv] - facilmente [adv]
alambic	[n] - alambicco [n]
alarme	[n] - allarme [n]
album	[n] - album [n.m.sp]
albédo	[n] - albedo [n]
alchimie	[n] - alchimia [n]
alchimiste	[n] - alchimista [adj]
alcool	[n] - alcoli [n]
alcoolique	[adj.mf] - alcolico [n]
alcoolique	[n.mf] - alcolico [n]
alcoolisme	[n.f] - alcolismo [n]
alerte	[adv] - avvisatamente [adv]
algue	[n] - alga [n]
algérien	[adj] - algerino [adj]
aligner	[vblex] - allineare [vblex]
alimentation	[n] - mangime [n.m]
alimenter	[vblex] - alimentare [adj]
aliénation	[n] - alienazione [n]
aliénation	[n] - trasferimento [n.m]
allant	[adj] - attivo [adj]
allant	[n.m] - disposizione [n]
allemand	[adj] - tedesco [adj]
allemand	[n] - tedesco [adj]
aller	[n.m] - monte ida [n]
aller	[vblex] - andare [vblex]
allergie	[n] - allergia [n]
alliage	[n.m] - lega [n]
alliance	[n] - alleanza [n]
allié	[n] - alleato [adj]
allouer	[vblex] - concedere [vblex]
allumer	[vblex] - accendere [vblex]
allure	[n.f] - aspetto [n]
allusion	[n] - allusione [n]
alluvion	[n.f] - alluvione [n]
allègrement	[adv] - allegramente [adv]
allégorie	[n] - allegoria [n]
allégresse	[n] - gioiello [n]
alors	[adv] - allora [adv]
alors	[cnjadv] - allora [adv]
alors que	[cnjadv] - mentre [cnjcoo]
alphabet	[n] - alfabeto [n]
alphabétique	[adj.mf] - alfabetico [adj]
alpin	[adj] - alpino [adj]
altercation	[n.f] - conflitto [n]
alterne	[adj.mf] - alternato [adj]
alterner	[vblex] - alternare [vblex]
altitude	[n] - altitudine [n]
altérer	[vblex] - alterare [vblex]
aluminium	[n] - alluminio [n]
aléa	[n] - caso [n]
amabilité	[n] - amabilità [n]
amalgame	[n.m] - amalgama [n]
amande	[n] - mandorla [n]
amandier	[n] - mandorlo [n]
amant	[n.f] - amante [n]
amant	[n.GD] - amante [n]
amant	[n.m] - amante [n]
amas	[n.m.sp] - mucchio [n]
amasser	[vblex] - accumulare [vblex]
amateur	[adj.mf] - amatore [n]
ambassade	[n] - agente diplomatico [n]
ambassadeur	[n] - ambasciatore [n]
ambiance	[n.f] - ambiente [n]
ambitieux	[adj.f] - ambizioso [adj]
ambitieux	[adj.m.sp] - ambizioso [adj]
ambitieux	[adj] - ambizioso [adj]
ambition	[n] - ambizione [n]
ambulance	[n] - ambulanza [n]
amen	[n] - amen [n]
amende	[n] - multa [n]
amendement	[n.m] - emendamento [n]
amener	[vblex] - portare [vblex]
ameublement	[n] - arredo [n]
ami	[adj] - amico [n]
ami	[n] - amico [n]
amicale	[n] - associazione [n]
amiral	[n] - ammiraglio [n]
amitié	[n] - amicizia [n]
amortissement	[n.m] - ammortamento [n.m]
amour	[n] - amato [n]
amoureux	[adj.f] - innamorato [n]
amoureux	[adj.m.sp] - innamorato [n]
amphithéâtre	[n] - anfiteatro [n]
amphitryon	[adj] - anfitrione [n]
ampleur	[n] - ampiezza [n]
ampoule	[n] - vescica [n]
amusement	[n.m] - divertimento [n]
amuser	[vblex] - divertir [vblex]
améliorer	[vblex] - migliorare [vblex]
aménagement	[n.m] - disposizione [n]
américain	[adj.f] - statunitense [adj]
américain	[adj.GD] - statunitense [adj]
américain	[adj.m] - statunitense [adj]
américain	[adj] - americano [adj]
américain	[n] - americano [adj]
an	[n] - anno [n]
anal	[adj.f] - anale [adj]
anal	[adj.GD] - anale [adj]
anal	[adj.m] - anale [adj]
analogue	[adj.mf] - analogo [adj]
analphabète	[adj.mf] - analfabeta [n]
analyse	[n.f.ND] - analisi [n]
analyse	[n.f.pl] - analisi [n]
analyse	[n.f.sg] - analisi [n]
analyse	[n] - analisi [n]
analyste	[n] - analista [n]
analytique	[n.f] - analitico [adj]
anarchique	[adj.mf] - anarchico [adj]
anarchisme	[n] - anarchismo [n]
anarchiste	[adj] - anarchico [adj.f]
anatomique	[adj.mf] - anatomico [adj]
ancestral	[adj.f] - ancestrale [adj]
ancestral	[adj.GD] - ancestrale [adj]
ancestral	[adj.m] - ancestrale [adj]
ancien	[adj] - antico [adj]
ancien	[n] - anziano [n]
anciennement	[adv] - anticamente [adv]
ancre	[n] - ancora [n]
anecdote	[n] - aneddoto [n]
anesthésie	[n] - anestesia [n]
ange	[n] - angelo [n]
anglais	[adj.f] - inglese [n]
anglais	[adj.m.sp] - inglese [n]
anglais	[n.f] - inglese [n]
anglais	[n.m.sp] - inglese [n]
angle	[n] - angolo [n]
anglican	[adj] - anglicanesimo [n]
anglo-saxon	[adj] - anglosassoni [n]
animal	[n] - animale [adj]
animation	[n] - animazione [n]
animer	[vblex] - animare [vblex]
animosité	[n] - ripugnanza [n]
annal	[adj.f] - annuale [adj]
annal	[adj.m] - annuale [adj]
annales	[n.f] - annale [n]
anneau	[n] - anello [n]
annexe	[n.f] - allegato [n]
anniversaire	[n.m.ND] - compleanno [n]
anniversaire	[n.m.pl] - compleanno [n]
anniversaire	[n.m.sg] - compleanno [n]
anniversaire	[n] - anniversario [n]
annonce	[n] - ad [n]
annoncer	[vblex] - annunciare [vblex]
annonciation	[n] - annunciazione [n]
annotation	[n] - annotazione [n]
annuaire	[n] - annuario [n]
annuel	[adj.f] - annuale [adj]
annuel	[adj.GD] - annuale [adj]
annuel	[adj.m] - annuale [adj]
annuellement	[adv] - annualmente [adv]
annulation	[n] - annullamento [n.m]
annuler	[vblex] - anulare [adj]
année	[n.f] - anno [n]
anomalie	[n] - anormalità [n.f.sp]
anonymat	[n] - anonimato [n]
anonyme	[adj.mf] - anonimità [n]
anorexie	[n] - anoressia [n]
anormal	[adj.f] - anormale [adj]
anormal	[adj.GD] - anormale [adj]
anormal	[adj.m] - anormale [adj]
antagoniste	[adj] - antagonista [n]
antenne	[n] - antenna [n]
antibiotique	[adj.mf] - antibiotico [n]
antichambre	[n] - anticamera [n]
anticipation	[n] - aspettativa [n]
anticiper	[vblex] - anticipare [vblex]
anticyclone	[n] - anticiclone [n]
antipode	[n.m] - antipode [adj]
antique	[adj.mf] - antico [adj]
antérieur	[adj.f] - anteriore [adj]
antérieur	[adj.GD] - anteriore [adj]
antérieur	[adj.m] - anteriore [adj]
antérieurement	[adv] - anteriormente [adv]
anxieux	[adj.f] - ansioso [adj]
anxieux	[adj.m.sp] - ansioso [adj]
anxiété	[n] - ansia [n]
anéantir	[vblex] - annientare [vblex]
anémie	[n] - anemia [n]
août	[n] - agosto [n.m]
apathie	[n] - apatia [n]
aperçu	[n.m] - percezione [n]
aphrodisiaque	[adj.mf] - afrodisiaco [adj]
apologie	[n] - apologia [n]
apparemment	[adv] - apparentemente [adv]
apparence	[n.f] - simile [adj]
apparence	[n] - fenomeno [n]
apparition	[n] - apparizione [n]
appartement	[n] - appartamento [n]
appartement	[n] - pavimento [n]
appartenance	[n] - appartenenza [n]
appartenant	[adj.f] - appartenente [adj]
appartenant	[adj.GD] - appartenente [adj]
appartenant	[adj.m] - appartenente [adj]
appartenir	[vblex] - appartenere [vblex]
appauvrir	[vblex] - impoverire [vblex]
appellation	[n] - appello [n.m]
appendice	[n] - appendice [n.f]
applaudir	[vblex] - applaudire [vblex]
applaudissement	[n] - applauso [n]
applicable	[adj] - applicabile [adj]
application	[n] - applicazione [n]
appliquer	[vblex] - applicare [vblex]
appointer	[vblex] - pagare [vblex]
apprendre	[vblex] - apprendere [vblex]
apprenti	[n] - apprendista [n.m]
apprentissage	[n] - apprendimento [n]
approbation	[n] - consenso [n]
approchant	[adv] - approssimativamente [adv]
approche	[n.f] - accesso [n]
approfondir	[vblex] - intensificare [vblex]
approprié	[adj] - adeguato [adj]
approvisionner	[vblex] - fornire [vblex]
approximation	[n] - ravvicinamento [n.m]
apprécier	[vblex] - apprezzare [vblex]
apprêt	[n] - addobbo [n]
appuyer	[vblex] - appoggiare [vblex]
appuyer sur	[vblex] - pulsare [vblex]
appétissant	[adj] - appetitoso [adj]
appétit	[n.m] - voglia [n]
appétit	[n] - appetito [n]
après	[adv] - dopo [adv]
après	[pr] - dietro [pr]
après	[pr] - dopo [pr]
après que	[cnjadv] - dopo di che [pr]
après-midi	[n.m.sp] - in ritardo [adv]
après-midi	[n.m] - in ritardo [adv]
apéritif	[adj] - aperitivo [n]
apéritif	[n] - aperitivo [n]
apôtre	[n] - apostolo [n]
aquarelle	[n] - acquerello [n.m]
aquatique	[adj.mf] - acquatico [adj]
arabe	[adj] - arabo [adj]
arabe	[n] - arabo [adj]
aragonais	[adj.f] - aragonese [adj]
aragonais	[adj.m.sp] - aragonese [adj]
araignée	[n] - ragno [n]
arbitrage	[n] - arbitrato [n]
arbitral	[adj.f] - arbitrale [adj]
arbitral	[adj.GD] - arbitrale [adj]
arbitral	[adj.m] - arbitrale [adj]
arbitre	[n] - arbitro [n.m]
arbre	[n] - albero [n]
arc	[n] - sopracciglio [n]
archange	[n] - arcangelo [n]
arche	[n.f] - sopracciglio [n]
archevêque	[n] - arcivescovo [n]
archipel	[n] - arcipelago [n]
architecte	[n.mf] - architetto [n]
architecture	[n] - architettura [n]
archives	[n.f.pl] - archivio [n]
archéologique	[adj.mf] - archeologico [adj]
ardent	[adj.f] - ardente [adj]
ardent	[adj.GD] - ardente [adj]
ardent	[adj.m] - ardente [adj]
ardu	[adj] - arduo [adj]
argent	[n.m.sg] - moneta [n.f]
argent	[n.m] - argento [n]
argentin	[adj] - argentino [adj]
argentin	[n] - argentino [adj]
argile	[n] - argilla [n]
argot	[n] - argot [n]
arithmétique	[n] - aritmetica [n]
arme	[n] - arma [n]
armistice	[n] - armistizio [n]
armoire	[n] - armadio [n]
armée	[n.f] - armata [n]
arnaque	[n.f] - timo [n]
arraché	[n.m] - avvio [n]
arrestation	[n.f] - arresto [n]
arrestation	[n] - arresto [n]
arriver	[vblex] - arrivare [vblex]
arrivée	[n] - arrivo [n]
arrière	[adj.mf.sp] - posteriore [adj]
arrondissement	[n] - arrotondamento [n]
arrosage	[n] - irrigazione [n.f]
arrêter	[vblex] - arrestare [vblex]
arrêter	[vblex] - detenere [vblex]
arsenal	[n] - arsenale [n]
art	[n.m] - attrezzo [n.m]
art	[n] - attrezzo [n.m]
artichaut	[n.m] - carciofo [n]
article	[n] - articolo [n]
articulation	[n] - giuntura [n]
articuler	[vblex] - articolare [vblex]
artificiel	[adj.f] - artificiale [adj]
artificiel	[adj.GD] - artificiale [adj]
artificiel	[adj.m] - artificiale [adj]
artificiellement	[adv] - artificialmente [adv]
artisan	[adj] - artigiano [n]
artisan	[n] - artigiano [n]
artisanal	[adj.f] - artigianale [adj]
artisanal	[adj.GD] - artigianale [adj]
artisanal	[adj.m] - artigianale [adj]
artiste	[n] - artista [n.m]
artistique	[adj.mf] - artistico [adj]
artère	[n] - arteria [n]
arène	[n] - sabbia [n]
arôme	[n.m] - aroma [n]
as	[n.m.sp] - as [n]
ascendant	[adj.f] - ascendente [n.m]
ascendant	[adj.f] - ascendente [n]
ascendant	[adj.GD] - ascendente [n.m]
ascendant	[adj.GD] - ascendente [n]
ascendant	[adj.m] - ascendente [n.m]
ascendant	[adj.m] - ascendente [n]
aspect	[n] - aspetto [n]
aspirateur	[adj] - aspirapolvere [n]
aspirateur	[n.m] - aspirapolvere [n]
aspiration	[n] - aspirazione [n]
aspirer	[vblex] - aspirare [vblex]
assaillir	[vblex] - assaltare [vblex]
assassin	[n] - assassino [n]
assassinat	[n] - assassinio [n]
assassiner	[vblex] - assassinare [vblex]
assemblée	[n] - assemblea [n]
assez	[adv] - abbastanza [adv]
assidu	[adj] - assiduo [adj]
assiette	[n.f] - piatto [n]
assigner	[vblex] - assegnare [vblex]
assimilation	[n] - assimilazione [n]
assimiler	[vblex] - assimilare [vblex]
assise	[n] - conferenza [n]
assistance	[n] - concorso [n.m]
assistant	[n.f] - aiutante [n]
assistant	[n.f] - badante [n]
assistant	[n.GD] - badante [n]
assistant	[n.m] - aiutante [n]
assistant	[n.m] - badante [n]
assister	[vblex] - assistere [vblex]
association	[n] - associazione [n]
associer	[vblex] - associare [vblex]
assommer	[vblex] - uccidere [vblex]
assomption	[n] - assunzione [n]
assoupir	[vblex] - dormire [vblex]
assoupissement	[n.m] - apatia [n]
assurance	[n.f] - certamente [adv]
assurer	[vblex] - assicurare [vblex]
asthme	[n.m] - asma [n]
astre	[n] - stella [n]
astronaute	[n] - astronauta [n]
astronome	[n.mf] - astronomo [n]
astuce	[n] - astuzia [n]
asturien	[adj] - asturiano [adj]
asturien	[n] - asturiano [adj]
asymétrie	[n] - asimmetria [n]
asymétrique	[adj.mf] - asimmetrico [adj]
athlète	[adj] - atleta [n]
athlète	[n] - atleta [n]
athlétisme	[n] - atletica leggera [n]
atlantique	[adj.mf] - atlantico [adj]
atmosphère	[n] - atmosfera [n]
atomique	[adj.mf] - atomico [adj]
atout	[n.m] - bazza [n]
attachement	[n] - attaccamento [n]
attendre	[vblex] - aspettare [vblex]
attentat	[n] - attentato [n]
attente	[n] - attesa [n]
attentif	[adj] - attento [adj]
attention	[n] - attenzione [n]
attentivement	[adv] - attentamente [adv]
atterrir	[vblex] - atterrare [vblex]
attester	[vblex] - testimoniare [vblex]
attique	[n.f] - attico [n]
attirer	[vblex] - attrarre [vblex]
attitude	[n] - atteggiamento [n.m]
attractif	[adj] - attrazione [n.f]
attrait	[n] - attrazione [n.f]
attribuer	[vblex] - attribuire [vblex]
attribut	[n] - attributo [n]
attribution	[n] - allocazione [n]
au cas où	[cnjadv] - nel caso in cui [adv]
au cas que	[cnjadv] - nel caso in cui [adv]
au cours de	[pr] - durante [pr]
au delà	[adv] - oltre [adv]
au dire de	[pr] - secondo [pr]
au dos	[adv] - alla schiena [adv]
