a	[pr] - à [pr]
a breve	[adv] - dans peu de temps [adv]
a breve termine	[adv] - à court terme [adv]
a cielo aperto	[adv] - à ciel ouvert [adv]
a cosa	[adv] - pour que [cnjadv]
a fondo	[adv] - à fond [adv]
a fronte	[adv] - devant [adv]
a grande scala	[adv] - à grande échelle [adv]
a lungo termine	[adv] - à long terme [adv]
a mano	[adv] - à la main [adv]
a meno che	[adv] - à moins que [cnjadv]
a morte	[adv] - à mort [adv]
a parte	[adv] - à part [adv]
a rate	[adv] - à crédit [cnjadv]
a riga	[cnjadv] - en respect [adv]
a scala ridotta	[adv] - à petite échelle [adv]
a tal proposito	[adv] - à cet égard [adv]
a tal riguardo	[adv] - à cet égard [adv]
a volte	[adv] - de temps en autre [adv]
a volte	[adv] - parfois [adv]
abate	[n.m] - abbé [n]
abbandonare	[vblex] - abandonner [vblex]
abbandono	[n] - abandon [n]
abbassare	[vblex] - abaisser [vblex]
abbasso	[adv] - en bas [adv]
abbastanza	[adv] - assez [adv]
abbattere	[vblex] - abattre [vblex]
abbattimento	[n.m] - abattement [n]
abbazia	[n.f] - abbaye [n]
abbigliamento	[n] - accoutrement [n.m]
abbigliamento	[n] - tenue [n.f]
abbigliamento	[n] - vêtements [n.m.pl]
abbigliamento	[n] - vêtement [n.m]
abbonamento	[n] - payement [n]
abbondante	[adj] - abondant [adj.f]
abbondanza	[n] - abondance [n]
abbondare	[vblex] - abonder [vblex]
abbordaggio	[n] - abordage [n]
abbracciare	[vblex] - embrasser [vblex]
abbraccio	[n] - embrassade [n.f]
abbreviare	[vblex] - abréger [vblex]
abbuono	[n.m] - reduction [n]
abdicare	[vblex] - abdiquer [vblex]
aberrazione	[n] - aberration [n]
abete	[n] - sapin [n]
abile	[adj] - adroit [adj.f]
abilitazione	[n] - habilitation [n]
abilità	[n.f.sp] - habilité [n]
abisso	[n] - abîme [n]
abitabilità	[n.f.sp] - habitabilité [n]
abitante	[n] - habitant [n.f]
abitare	[vblex] - habiter [vblex]
abitatore	[n.f] - habitant [n.f]
abitatore	[n.m] - habitant [n.f]
abitazione	[n] - chambre [n]
abito	[n] - robe [n.f]
abito talare	[n] - soutane [n]
abituale	[adj] - habituel [adj.f]
abituale	[n] - habituel [adj.f]
abitualmente	[adv] - habituellement [adv]
abitudine	[n] - moeurs [n.f.pl]
ablazione	[n] - ablation [n]
abnegazione	[n] - abnégation [n]
abolizione	[n] - abolition [n]
aborigeno	[n.f] - aborigène [n]
aborigeno	[n.GD] - aborigène [n]
aborigeno	[n.m] - aborigène [n]
abortire	[vblex] - avorter [vblex]
aborto	[n] - avortement [n]
abusare	[vblex] - abuser [vblex]
abuso	[n] - abus [n.m.sp]
accademia	[n] - académie [n]
accademico	[adj] - académique [adj.mf]
accamparsi	[vblex] - camper [vblex]
accedere	[vblex] - accéder [vblex]
acceleratore	[adj] - accélérateur [adj]
accelerazione	[n] - accélération [n]
accellerare	[vblex] - accélérer [vblex]
accendere	[vblex] - allumer [vblex]
accento	[n] - accent [n]
accesso	[n] - approche [n.f]
accessorio	[n] - accessoire [adj.mf]
accettabile	[adj] - acceptable [adj]
accettare	[vblex] - accepter [vblex]
accettazione	[n] - acceptation [n]
acciaio	[n] - acier [n]
accidentale	[adj] - accidentel [adj.f]
accidentalmente	[adv] - accidentellement [adv]
acclamare	[vblex] - acclamer [vblex]
acclamazione	[n] - acclamation [n]
acclimatare	[vblex] - acclimater [vblex]
acclimatazione	[n] - acclimatation [n]
accompagnare	[vblex] - accompagner [vblex]
accordare	[vblex] - accorder [vblex]
accordare	[vblex] - convenir [vblex]
accordo	[n] - accord [n]
accreditamento	[n.m] - accréditation [n]
accreditare	[vblex] - accréditer [vblex]
accumulare	[vblex] - accumuler [vblex]
accumulazione	[n] - accumulation [n]
accusare	[vblex] - accuser [vblex]
aceto	[n] - vinaigre [n]
acido	[adj] - acide [adj.mf]
acido	[n] - acide [adj.mf]
aconfessionale	[adj] - non confessionnel [adj.f]
acqua	[n] - eau [n]
acquaneve	[n] - neige fondue [n]
acquata	[n] - averse [n.f]
acquatico	[adj] - aquatique [adj.mf]
acquerello	[n.m] - aquarelle [n]
acquirente	[n.mf] - acheteur [n]
acquirente	[n] - acheteur [n]
acquisizione	[n] - acquisition [n]
acquisto	[n.m] - achat [n.m]
acquisto	[n.m] - acquisition [n]
acquisto	[n] - achat [n.m]
acrobazia	[n] - acrobatie [n]
acronimo	[n] - sigle [n.m]
acustica	[n] - acoustique [n]
acusticamente	[adv] - acoustiquement [adv]
acustico	[adj] - acoustique [adj.mf]
ad	[n] - annonce [n]
ad ogni modo	[adv] - dans tous les cas [adv]
adattamento	[n] - remaniement [n.m]
adattare	[vblex] - adapter [vblex]
addestrare	[vblex] - entraîner [vblex]
addirittura	[adv] - dessus [adv]
additivo	[n] - additif [adj]
addobbo	[n] - apprêt [n]
addome	[n] - abdomen [n]
addossare	[vblex] - adosser [vblex]
adeguamento	[n.m] - remaniement [n.m]
adeguare	[vblex] - adapter [vblex]
adeguatamente	[adv] - adéquatement [adv]
adeguato	[adj] - approprié [adj]
adesione	[n] - ralliement [n.m]
adesivo	[adj] - adhésif [adj]
adesso	[adv] - maintenant [adv]
adhd	[n] - hyperactivité [n]
adiacente	[adj] - adjacent [adj.f]
adolescente	[adj] - adolescent [n.f]
adolescente	[n] - adolescent [n.f]
adolescenza	[n] - adolescence [n]
adorabile	[adj] - adorable [adj]
adorare	[vblex] - adorer [vblex]
adornare	[vblex] - agrémenter [vblex]
adorno	[n] - ornement [n]
adottare	[vblex] - adopter [vblex]
adozione	[n] - adoption [n]
adozionismo	[n] - dynamisme [n]
adrenalina	[n] - adrénaline [n]
adulterare	[vblex] - dénaturer [vblex]
adulterio	[n] - adultère [n]
adulto	[n] - adulte [n.mf]
aerodinamico	[adj] - aérodynamique [adj.mf]
aerodromo	[n] - aérodrome [n]
aeromobile	[n] - aéronef [n.m]
aeronautico	[adj] - aéronautique [adj.mf]
aeroplano	[n] - avion [n]
aeroplano	[n] - aéroplane [n]
aeroporto	[n] - aéroport [n]
affabile	[adj] - affable [adj]
affamato	[adj] - affamé [adj]
affascinante	[adj] - fascinant [adj.f]
affermare	[vblex] - affirmer [vblex]
affermativo	[adj] - affirmatif [adj]
affermazione	[n.f] - affirmation [n]
affettivo	[adj] - affectif [adj]
affilato	[adj] - aiguisé [adj]
affiliare	[vblex] - affilier [vblex]
affiliazione	[n] - affiliation [n]
affinché	[cnjsub] - pour que [cnjadv]
affinità	[n.f.sp] - affinité [n]
affitto	[n] - location [n.f]
affitto	[n] - location [n]
affliggere	[vblex] - affliger [vblex]
affluente	[n] - affluent [n]
affluenza	[n] - affluence [n]
afflusso	[n.m] - affluence [n]
affresco	[n] - frais [adj.f]
affrontare	[vblex] - affronter [vblex]
afrodisiaco	[adj] - aphrodisiaque [adj.mf]
agente diplomatico	[n] - ambassade [n]
agenzia	[n] - agence [n]
aggettivo	[n] - adjectif [n]
aggiornamento	[n.m] - actualisation [n]
aggiornamento	[n] - actualisation [n]
aggiornare	[vblex] - actualiser [vblex]
aggravare	[vblex] - empirer [vblex]
aggredire	[vblex] - agresser [vblex]
aggressione	[n.f] - agression [n]
aggressività	[n.f.sp] - agressivité [n]
aggressivo	[adj] - agressif [adj]
aggressore	[n] - agresseur [n]
agile	[adj] - agile [adj]
agilità	[n.f.sp] - agilité [n]
agitare	[vblex] - affairer [vblex]
aglio	[n] - ail [n]
agnello	[n] - agneau [n.m]
ago	[n.m] - aiguille [n.f]
agonia	[n.f] - agonie [n]
agonizzare	[vblex] - agoniser [vblex]
agosto	[n.m] - août [n]
agosto	[n] - août [n]
agricolo	[adj] - agricole [adj]
agricoltore	[adj] - agriculteur [n]
agricoltore	[n] - agriculteur [n]
agricoltura	[n] - agriculture [n]
aids	[n] - sida [n]
aiutante	[n] - assistant [n.f]
aiutare	[vblex] - aider [vblex]
aiuto	[n.m] - aide [n.f]
aiuto	[n] - aide [n.f]
al giorno	[adv] - à jour [cnjadv]
al giorno d'oggi	[adv] - aujourd'hui [adv]
al meno	[adv] - au moins [adv]
al momento	[adv] - pour l'instant [adv]
ala	[n] - aile [n]
alambicco	[n] - alambic [n]
alba	[n] - matin [n.m]
albedo	[n] - albédo [n]
albergo	[n] - hôtel [n]
albero	[n] - arbre [n]
albero	[n] - bâton [n]
album	[n.m.sp] - album [n]
alchimia	[n] - alchimie [n]
alchimista	[adj] - alchimiste [n]
alchimista	[n] - alchimiste [n]
alcoli	[n] - alcool [n]
alcolico	[n] - alcoolique [adj.mf]
alcolismo	[n] - alcoolisme [n.f]
alcool	[n] - alcool [n]
alcun	[det.ind] - quelque [det.ind.mf]
alcunché	[prn] - quelque chose [prn.tn.nt.sg]
alcuno	[prn.tn.f.pl] - un [det.ind.mf.pl]
alcuno	[prn.tn.f] - quelque [det.ind.mf]
alcuno	[prn.tn.m.pl] - un [det.ind.mf.pl]
alcuno	[prn.tn.m] - quelque [det.ind.mf]
alfabetico	[adj] - alphabétique [adj.mf]
alfabeto	[n] - alphabet [n]
alga	[n] - algue [n]
algerino	[adj] - algérien [adj]
algerino	[n] - algérien [adj]
alicante	[n] - d'Alicante [adj.mf.sp]
alienazione	[n] - aliénation [n]
alimentare	[adj] - alimenter [vblex]
alimentare	[n] - alimenter [vblex]
alimentazione	[n] - alimentation [n]
alimento	[n] - nourriture [n.f]
all'esterno	[adv] - dehors [adv]
all'interno	[adv] - dedans [adv]
all'interno	[adv] - à dedans [adv]
alla difensiva	[adv] - sur la défensive [adv]
alla schiena	[adv] - au dos [adv]
allacciare	[vblex] - raccorder [vblex]
allarme	[n.m] - alerte [adv]
allarme	[n] - alarme [n]
alle spalle	[adv] - au dos [adv]
alleanza	[n] - alliance [n]
alleato	[adj] - allié [n]
alleato	[n] - allié [n]
allegato	[n] - annexe [n.f]
allegato	[n] - appendice [n]
allegoria	[n] - allégorie [n]
allegramente	[adv] - allègrement [adv]
allenamento	[n] - entraînement [n]
allenare	[vblex] - entraîner [vblex]
allergia	[n] - allergie [n]
allerta	[n] - alerte [adv]
allevamento	[n] - élevage [n.m]
allevamento	[n] - éleveur [n]
alleviare	[vblex] - soulager [vblex]
allievo	[adj] - scolaire [adj]
allineare	[vblex] - aligner [vblex]
allo stesso tempo	[adv] - en même temps [adv]
allocazione	[n] - adjudication [n]
allocazione	[n] - attribution [n]
allocuzione	[n.f] - discours [n.m.sp]
alloggio	[n] - hébergement [n]
allora	[adv] - alors [adv]
alloro	[n] - laurier [n]
allucinazione	[n] - hallucination [n]
alludere	[vblex] - faire allusion à [vblex]
alluminio	[n] - aluminium [n]
allusione	[n] - allusion [n]
alluvione	[n] - alluvion [n.f]
alluvione	[n] - inondation [n]
almeno	[adv] - au moins [adv]
alpino	[adj] - alpin [adj]
altamente	[adv] - hautement [adv]
altare	[n] - autel [n]
alterare	[vblex] - altérer [vblex]
alternare	[vblex] - alterner [vblex]
alternato	[adj] - alterne [adj.mf]
altezza	[n] - haut [n.m]
altitudine	[n] - altitude [n]
alto	[adj] - grand [adj]
altoparlante	[n] - haut-parleur [n]
altrimenti	[adv] - façon [n.f]
altro	[adj] - autre [adj.mf]
altro	[adj] - autres [adj]
altro	[prn.tn] - autre [adj.mf]
alzare	[vblex] - dresser [vblex]
alzare	[vblex] - hausser [vblex]
amabilità	[n] - amabilité [n]
amabilmente	[adv] - aimablement [adv]
amalgama	[n] - amalgame [n.m]
amante	[n] - amant [n.f]
amante	[n] - fiancé [n]
amare	[vblex] - aimer [vblex]
amare	[vblex] - avoir envie de [vblex]
amato	[n] - amour [n]
amatore	[n] - amateur [adj.mf]
ambasciata	[n] - ambassade [n]
ambasciatore	[n] - ambassadeur [n]
ambedue	[adj] - les deux [det]
ambientale	[adj] - environnemental [adj.f]
ambientare	[vblex] - situer [vblex]
ambiente	[n] - ambiance [n.f]
ambiente	[n] - entourage [n]
ambito	[n] - cadre [n]
ambizione	[n] - ambition [n]
ambizioso	[adj] - ambitieux [adj.f]
ambulanza	[n] - ambulance [n]
amen	[n] - amen [n]
americano	[adj] - américain [adj]
americano	[n] - américain [adj]
amicizia	[n] - amitié [n]
amico	[n] - ami [adj]
ammalato	[n] - malade [adj.mf]
ammettere	[vblex] - admettre [vblex]
amministrare	[vblex] - administrer [vblex]
amministrativo	[adj] - administratif [adj]
amministrativo	[n] - administratif [adj]
amministratore	[n] - administrateur [n]
amministratore	[n] - exécutif [n]
amministratore delegato	[n] - gérent [n.f]
amministrazione	[n] - administration [n]
amministrazione	[n] - gérance [n]
ammirabile	[adj] - admirable [adj]
ammiraglio	[n] - amiral [n]
ammirare	[vblex] - admirer [vblex]
ammirazione	[n] - admiration [n]
ammodernamento	[n.m] - modernisation [n]
ammortamento	[n.m] - amortissement [n.m]
ammutinamento	[n] - émeute [n.f]
amo	[n] - maître [n]
amore	[n] - amour [n]
ampiamente	[adv] - de trop [adv]
ampiamente	[adv] - largement [adv]
ampiezza	[n] - ampleur [n]
ampliamento	[n] - acroissement [n.m]
ampliare	[vblex] - élargir [vblex]
anale	[adj] - anal [adj.f]
analfabeta	[n] - analphabète [adj.mf]
analisi	[n] - analyse [n.f.ND]
analista	[n] - analyste [n]
analitico	[adj] - analytique [n.f]
analogo	[adj] - analogue [adj.mf]
anarchico	[adj.f] - anarchiste [adj]
anarchico	[adj.GD] - anarchiste [adj]
anarchico	[adj.m] - anarchiste [adj]
anarchico	[adj] - anarchique [adj.mf]
anarchico	[n.f] - anarchiste [adj]
anarchico	[n.GD] - anarchiste [adj]
anarchico	[n.m] - anarchiste [adj]
anarchico	[n] - anarchique [adj.mf]
anarchismo	[n] - anarchisme [n]
anatomico	[adj] - anatomique [adj.mf]
anatra	[n] - canard [n]
anca	[n] - hanche [n]
ancestrale	[adj] - ancestral [adj.f]
anche	[adv] - aussi [adv]
anche se	[cnjsub] - bien que [cnjadv]
ancora	[adv] - encore [adv]
ancora	[adv] - même [adv]
ancora	[n] - ancre [n]
andare	[vblex] - aller [vblex]
aneddoto	[n] - anecdote [n]
anello	[n] - anneau [n]
anemia	[n] - anémie [n]
anestesia	[n] - anesthésie [n]
anfiteatro	[n] - amphithéâtre [n]
anfitrione	[n] - amphitryon [adj]
angelo	[n] - ange [n]
anglicanesimo	[n] - anglican [adj]
anglosassoni	[n] - anglo-saxon [adj]
angolo	[n] - angle [n]
angolo	[n] - canton [n.m]
anima	[n] - âme [n]
animale	[adj] - animal [n]
animale	[n] - animal [n]
animare	[vblex] - animer [vblex]
animazione	[n] - animation [n]
annale	[n] - annales [n.f]
annegamento	[n] - noyade [n.f]
annientare	[vblex] - anéantir [vblex]
anniversario	[n] - anniversaire [n]
anno	[n] - année [n.f]
annotare	[vblex] - noter [vblex]
annotazione	[n] - annotation [n]
annuale	[adj] - annal [adj.f]
annualmente	[adv] - annuellement [adv]
annuario	[n] - annuaire [n]
annullamento	[n.m] - annulation [n]
annullamento	[n.m] - invalidation [n]
annunciare	[vblex] - afficher [vblex]
annunciazione	[n] - annonciation [n]
annuncio	[n] - annonce [n]
anonimato	[n] - anonymat [n]
anonimità	[n] - anonymat [n]
anonimità	[n] - anonyme [adj.mf]
anonimo	[n] - anonyme [adj.mf]
anoressia	[n] - anorexie [n]
anormale	[adj] - anormal [adj.f]
anormalità	[n.f.sp] - anomalie [n]
ansia	[n] - anxiété [n]
ansia	[n] - souhait [n]
ansia	[n] - transe [n]
ansioso	[adj] - anxieux [adj.f]
antagonista	[n] - antagoniste [adj]
antenna	[n] - antenne [n]
anteriore	[adj] - antérieur [adj.f]
anteriormente	[adv] - antérieurement [adv]
antibiotico	[n] - antibiotique [adj.mf]
anticamente	[adv] - anciennement [adv]
anticamera	[n] - antichambre [n]
anticiclone	[n] - anticyclone [n]
anticipare	[vblex] - anticiper [vblex]
anticipo	[n] - avance [n.f]
antico	[adj] - antique [adj.mf]
antipode	[adj] - antipode [n.m]
antipode	[n] - antipode [n.m]
anulare	[adj] - annuler [vblex]
anziano	[n] - âgé [adj]
apatia	[n] - apathie [n]
apatia	[n] - assoupissement [n.m]
ape	[n] - abeille [n]
aperitivo	[n] - apéritif [adj]
apertamente	[adv] - ouvertement [adv]
apertura alare	[n] - envergure [n]
apologia	[n] - apologie [n]
apostolo	[n] - apôtre [n]
apoteosico	[adj] - triomphal [adj]
apparato	[n.m] - rambarde [n]
apparecchiatura	[n.f] - équipe [n.f]
apparentemente	[adv] - apparemment [adv]
apparizione	[n] - apparition [n]
appartamento	[n] - appartement [n]
appartenente	[adj] - appartenant [adj.f]
appartenenza	[n] - appartenance [n]
appartenere	[vblex] - appartenir [vblex]
appello	[n.m] - appellation [n]
appena	[adv] - juste [adj.mf]
appena	[adv] - à peine [adv]
appendice	[n.f] - appendice [n]
appetito	[n] - appétit [n]
appetitoso	[adj] - appétissant [adj]
applaudire	[vblex] - applaudir [vblex]
applauso	[n] - applaudissement [n]
applicabile	[adj] - applicable [adj]
applicare	[vblex] - appliquer [vblex]
applicazione	[n] - application [n]
appoggiare	[vblex] - appuyer [vblex]
appoggio	[n] - soutien [n]
apprendere	[vblex] - apprendre [vblex]
apprendimento	[n] - apprenti [n]
apprendimento	[n] - apprentissage [n]
apprendista	[n.m] - apprenti [n]
apprezzare	[vblex] - apprécier [vblex]
approssimativamente	[adv] - approchant [adv]
aprile	[n.m.pl] - avril [n]
aprile	[n.m.sp] - avril [n]
aprile	[n] - avril [n]
aprire	[vblex] - ouvrir [vblex]
aquila	[n] - aigle [n.mf]
arabo	[adj] - arabe [adj]
aragonese	[adj] - aragonais [adj.f]
aragonese	[n] - aragonais [adj.f]
arancione	[n] - orange [n]
arare	[vblex] - ouvrer [vblex]
arazzo	[n] - tapisserie [n.f]
arazzo	[n] - tapisserie [n]
arbitrale	[adj] - arbitral [adj.f]
arbitrato	[n] - arbitrage [n]
arbitro	[n.m] - arbitre [n]
arbitro	[n] - arbitre [n]
arcangelo	[n] - archange [n]
archeologico	[adj] - archéologique [adj.mf]
architetto	[n] - architecte [n.mf]
architettura	[n] - architecture [n]
archivio	[n] - archives [n.f.pl]
arcipelago	[n] - archipel [n]
arcivescovo	[n] - archevêque [n]
ardente	[adj] - ardent [adj.f]
ardere	[vblex] - brûler [vblex]
arduo	[adj] - ardu [adj]
argentino	[adj] - argentin [adj]
argentino	[n] - argentin [adj]
argento	[n] - argent [n.m]
argilla	[n] - argile [n]
argot	[n] - argot [n]
aria	[n.f] - air [n]
aria	[n] - air [n]
aritmetica	[n] - arithmétique [n]
arma	[n] - arme [n]
arma da fuoco	[n] - coup [n]
armadio	[n] - armoire [n]
armata	[n] - armée [n.f]
armistizio	[n] - armistice [n]
armonia	[n] - harmonie [n]
arnese	[n] - outil [n.m]
aro	[n] - rond [n]
aroma	[n] - arôme [n.m]
arrampicata	[n] - escalade [n]
arredo	[n] - meubles [n.m.pl]
arrestare	[vblex] - arrêter [vblex]
arresto	[n.m] - paralysie [n]
arresto	[n] - arrestation [n.f]
arresto	[n] - détention [n.f]
arricchimento	[n] - enrichissement [n]
arrivare	[vblex] - arriver [vblex]
arrivederci	[ij] - au revoir [ij]
arrivo	[n] - arrivée [n]
arrotondamento	[n] - arrondissement [n]
arsenale	[n] - arsenal [n]
arte	[n] - art [n.m]
arteria	[n] - artère [n]
articolare	[vblex] - articuler [vblex]
articolo	[n] - article [n]
artificiale	[adj] - artificiel [adj.f]
artificialmente	[adv] - artificiellement [adv]
artigianale	[adj.mf] - propriétaire [n.mf]
artigianale	[adj] - artisanal [adj.f]
artigiano	[n] - artisan [adj]
artista	[n.m] - artiste [n]
artista	[n] - artiste [n]
artistico	[adj] - artistique [adj.mf]
arto	[n] - extrémité [n]
arto inferiore	[n] - jambe [n]
as	[n] - as [n.m.sp]
ascella	[n] - aisselle [n]
ascendente	[n.m] - ascendant [adj.f]
ascendente	[n] - ascendant [adj.f]
ascendere	[vblex] - monter [vblex]
ascia	[n] - hache [n]
asciugare	[vblex] - sécher [vblex]
ascoltare	[vblex] - écouter [vblex]
asfissiare	[vblex] - étouffer [vblex]
asimmetria	[n] - asymétrie [n]
asimmetrico	[adj] - asymétrique [adj.mf]
asino	[n] - âne [n.f]
asma	[n] - asthme [n.m]
aspettare	[vblex] - attendre [vblex]
aspettativa	[n] - anticipation [n]
aspettativa	[n] - expectative [n]
aspetto	[n.m] - versant [n.m]
aspetto	[n] - allure [n.f]
aspirapolvere	[n] - aspirateur [adj]
aspirare	[vblex] - aspirer [vblex]
aspirazione	[n] - aspiration [n]
assaltare	[vblex] - assaillir [vblex]
assassinare	[vblex] - assassiner [vblex]
assassinio	[n] - assassinat [n]
assassino	[n] - assassin [n]
asse	[n.mf] - axe [n]
asse	[n] - axe [n]
asse	[n] - fer à repasser [n.m]
assegnare	[vblex] - assigner [vblex]
assegno	[n] - chèque [n]
assemblea	[n] - assemblée [n]
assemblee romane	[n] - comice [n]
assenteismo	[n] - absentéisme [n]
assenza	[n] - absence [n]
assenza	[n] - faute [n]
assessore	[n] - conseiller municipal [n]
assestamento	[n] - colonie [n.f]
assicurare	[vblex] - assurer [vblex]
assicurazione	[n] - sûr [adj]
assiduo	[adj] - assidu [adj]
assimilare	[vblex] - assimiler [vblex]
assimilazione	[n] - assimilation [n]
assistenziale	[adj] - d'assistance [adj.mf.sp]
assistere	[vblex] - assister [vblex]
associare	[vblex] - associer [vblex]
associazione	[n] - amicale [n]
assolutamente	[adv] - absolument pas [adv]
assolutamente	[adv] - absolument [adv]
assolutismo	[n] - absolutisme [n]
assoluto	[adj] - absolu [adj]
assoluzione	[n] - absolution [n]
assolvere	[vblex] - acquitter [vblex]
assorbente	[adj] - absorbant [adj.f]
assorbente	[n] - absorbant [adj.f]
assorbimento	[n.m] - absorption [n]
assorbimento	[n] - absorption [n]
assorto	[adj] - absorbé [adj]
assunzione	[n] - assomption [n]
assunzione	[n] - embauche [n]
assurdo	[adj] - absurde [adj.mf]
asta	[n] - vente aux enchères [n]
astensione	[n] - abstention [n]
astinenza	[n] - abstinence [n]
astratto	[adj] - abstrait [adj]
astrazione	[n] - abstraction [n]
astronauta	[n] - astronaute [n]
astronomo	[n] - astronome [n.mf]
asturiano	[adj] - asturien [adj]
asturiano	[n] - asturien [adj]
astuto	[adj] - malin [adj]
astuzia	[n] - astuce [n]
atemporale	[adj] - intemporel [adj.f]
atlantico	[adj] - atlantique [adj.mf]
atleta	[n] - athlète [adj]
atletica leggera	[n] - athlétisme [n]
atmosfera	[n] - atmosphère [n]
atomico	[adj] - atomique [adj.mf]
attaccamento	[n] - attachement [n]
attaccare	[vblex] - coller [vblex]
atteggiamento	[n.m] - attitude [n]
attendibilità	[n.f.sp] - fiabilité [n]
attentamente	[adv] - attentivement [adv]
attentamente	[adv] - soigneusement [adv]
attentato	[n] - attentat [n]
attento	[adj] - attentif [adj]
attenuazione	[n.f] - soulagement [n]
attenzione	[n] - attention [n]
atterrare	[vblex] - atterrir [vblex]
attesa	[n] - attente [n]
attico	[n] - attique [n.f]
attitudine	[n] - attitude [n]
attivamente	[adv] - activement [adv]
attivare	[vblex] - déclencher [vblex]
attivista	[n.f.pl] - activiste [n]
attivista	[n.GD.pl] - activiste [n]
attivista	[n.m.pl] - activiste [n]
attivista	[n.mf.sg] - activiste [n]
attivista	[n] - activiste [n]
attività	[n.f.sp] - activité [n]
attivo	[adj] - actif [adj]
atto	[n.m] - acte [n.m]
attore	[n] - acteur [n]
attorno	[adv] - autour [adv]
attrarre	[vblex] - attirer [vblex]
attraversamento	[n] - pas [n.m.sp]
attraverso a	[pr] - à travers [pr]
attrazione	[n.f] - attractif [adj]
attrezzatura	[n.f] - équipe [n.f]
attrezzo	[n.m] - art [n.m]
attribuire	[vblex] - attribuer [vblex]
attributo	[n] - attribut [n]
attrito	[n.m] - friction [n]
attrito	[n] - friction [n]
attrito	[n] - frôlement [n]
attuale	[adj] - actuel [adj.f]
attualità	[n.f.sp] - actu [n]
attualmente	[adv] - actuellement [adv]
attualmente	[adv] - aujourd'hui [adv]
audace	[adj] - audacieux [adj.m.sp]
audiovisivo	[adj] - audiovisuel [adj.f]
audit	[n] - audit [n.m]
auditorium	[n] - auditorie [n]
audizione	[n] - audition [n]
augurare	[vblex] - augurer [vblex]
aula	[n] - salle de cours [n]
aumentare	[vblex] - augmenter [vblex]
ausiliario	[adj] - auxiliaire [adj]
ausiliario	[n.m] - auxiliaire [adj]
auspicare	[vblex] - attendre [vblex]
australiano	[adj] - australien [adj]
australiano	[n] - australien [adj]
austriaco	[adj] - autrichien [adj]
austriaco	[n] - autrichien [adj]
autenticamente	[adv] - authentiquement [adv]
autenticità	[n] - authenticité [n]
autentico	[adj] - véritable [adj.mf]
auto	[n.f.sp] - action [n.f.pl]
auto	[n.sp.sp] - action [n.f.pl]
autobus	[n] - bus [n.m.sp]
autocarro	[n] - camion [n]
automaticamente	[adv] - automatiquement [adv]
automobile	[adj] - automobile [n.f]
automobile	[n] - automobile [n.f]
automobile	[n] - voiture [n.f]
automobilismo	[n] - automobilisme [n]
autonomia	[n] - autonomie [n]
autopsia	[n] - autopsie [n]
autore	[n] - auteur [n.mf]
autoritario	[adj] - autoritaire [adj.mf]
autorità	[n.f.sp] - autorité [n]
autorizzazione	[n.f] - permis [n.m.sp]
autostrada	[n] - autoroute [n]
autoveicolo	[n] - automobile [n.f]
autovettura	[n.f] - tourisme [n]
autovettura	[n] - automobile [n.f]
autunno	[n] - automne [n.m]
avanguardia	[n] - avant-garde [n.m]
avanti	[adv] - devant [adv]
avanzare	[vblex] - devancer [vblex]
avatar	[n] - avatar [n]
avere	[n] - actif [n]
avere	[vbhaver] - actif [n]
avianca	[n] - sac [n]
avidamente	[adv] - avidement [adv]
avorio	[n] - ivoire [n]
avvantaggiare	[vblex] - dépasser [vblex]
avventuriero	[adj] - aventurier [adj]
avverbio	[n] - adverbe [n]
avversario	[n] - adversaire [n.mf]
avverso	[adj] - adverse [adj.mf]
avvertire	[vblex] - avertir [vblex]
avviamento	[n.m] - création [n]
avviare	[vblex] - stimuler [vblex]
avvicinamento	[n] - rapprochement [n.f]
avvio	[n] - arraché [n.m]
avvio	[n] - début [n]
avvisatamente	[adv] - alerte [adv]
avvocato	[n.m] - avocat [n]
avvocatura	[n] - barreau [n.m]
avvolgere	[vblex] - entortiller [vblex]
azienda	[n] - entreprise [n]
azione	[n.mf] - action [n]
azione	[n] - action [n]
azionista	[n.f.pl] - actionnaire [n]
azionista	[n.GD.pl] - actionnaire [n]
azionista	[n.m.pl] - actionnaire [n]
azionista	[n.mf.sg] - actionnaire [n]
azoto	[n] - nitrogène [n]
baccalà	[n] - morue [n.f]
bachelor	[n] - licence [n]
bachelor	[n] - licencié [adj]
bacino	[n] - barrage [n]
bacio	[n] - baiser [n]
badante	[n] - assistant [n.f]
baffo	[n] - moustache [n.f]
bagagliaio	[n] - coffre [n]
bagaglio	[n] - bagage [n]
bagnare	[vblex] - mouiller [vblex]
bagno	[n] - baignade [n.f]
bahia	[n] - baie [n]
baia	[n] - baie [n]
balaustra	[n] - rambarde [n]
balcone	[n] - balcon [n]
balena	[n] - baleine [n]
balla	[n.f] - paquet [n]
ballare	[vblex] - baller [vblex]
ballo	[n] - danse [n.f]
balneazione	[n.f] - baignade [n.f]
bambino	[n] - enfance [n]
bambino	[n] - enfant [n.mf]
bambino	[n] - enfant [n.m]
bambino	[n] - fille [n.f]
bambola	[n] - poignet [n.m]
bambola	[n] - poupée [n.f]
banale	[adj] - banal [adj.f]
banana	[n.f] - banane [n.f]
banana	[n] - banane [n.f]
banca	[n.f] - banc [n]
banca	[n] - banc [n]
banca	[n] - banque [n]
bancarotta	[adj] - banqueroute [n]
bancarotta	[n] - banqueroute [n]
banchetto	[n] - banquet [n]
bancone	[n] - barre [n]
banconota	[n.f] - billet [n]
banda	[n] - bande [n]
bandiera	[n.f] - pavillon [n]
bandiera	[n] - bannière [n.f]
bando	[n] - ban [n]
bar	[n] - bar [n]
bar	[n] - taverne [n]
baracca	[n] - cahute [n]
baratro	[n] - abîme [n]
baratto	[n] - échange [n]
barba	[n] - barbe [n]
barbiere	[n] - barbier [n]
barca	[n] - barque [n]
barca	[n] - bateau [n]
barile	[n] - baril [n]
barocco	[n] - baroque [adj.mf]
barometro	[n] - baromètre [n]
barone	[n] - baron [n]
barra	[n] - barre [n]
barzelletta	[n] - blague [n.f]
basare	[vblex] - baser [vblex]
basco	[adj] - basque [adj.mf]
base	[n] - base [n]
baseball	[n] - base-ball [n]
basicamente	[adv] - basiquement [adv]
basico	[adj] - basique [adj.mf]
basilica	[n] - basilique [n]
basso elettrico	[n] - baissier [adj.f]
bastone	[n] - canne [n.f]
battaglia	[n] - bataille [n]
battesimo	[n] - baptême [n]
bazza	[n] - atout [n.m]
belga	[adj] - belge [adj]
bellezza	[n] - beauté [n]
bello	[adj] - beau [adj]
bello	[adj] - joli [adj]
bene	[adv] - bien [adv]
bene	[n] - bien [adv]
beneficiario	[n] - bénéficiaire [adj.mf]
beneficio	[n] - bénéfice [n.f]
benessere	[n] - bien-être [n]
bensì	[cnjadv] - mais [cnjcoo]
benvenuto	[adj] - bienvenu [adj]
benzina	[n] - essence [n]
bere	[vblex] - boire [vblex]
berretto	[n] - bonnet [n.m]
bestia	[n] - bête [n]
bestiame	[n] - bétail [n]
bevanda	[n] - boisson [n]
biancazzurro	[adj] - bleu-blanc [adj.f]
bianco	[n] - blanc [adj]
biblioteca	[n] - bibliothèque [n]
bicchiere	[n] - verre [n]
bicicletta	[n] - vélo [n.m]
bilancia	[n] - balance [n]
bilanciamento	[n] - bilan [n]
bilancio	[n] - bilan [n]
bilaterale	[adj] - bilatéral [adj.f]
biografia	[n] - biographie [n]
biologia	[n] - biologie [n]
biologia	[n] - biologiste [n.mf]
biologico	[adj] - bio [adj.mf.sp]
biologo	[n] - biologiste [n.mf]
biondo	[adj] - blond [adj]
birra	[n] - bière [n]
biscotto	[n.m] - biscuit [n.m]
bloccare	[vblex] - bloquer [vblex]
blocco	[n] - blocage [n]
blog	[n] - blog [n]
blu	[adj.mf.sp] - azur [adj.mf.sp]
bluff	[n] - fanal [n.m]
bocca	[n] - bouche [n]
bocciare	[n] - négative [n]
boccone	[n] - bouchée [n.f]
bolletta	[n] - facture [n]
bomba	[n] - bombe [n]
bonifico	[n.m] - transfert [n.m]
bono	[n] - bon [n]
bordare	[vblex] - broder [vblex]
borghesia	[n] - bourgeois [adj.f]
borghesia	[n] - bourgeoisie [n]
borsa	[n] - sac [n.m]
borsello	[n] - portefeuille [n.m]
borsello	[n] - sac [n]
borsistico	[adj] - boursier [adj.f]
bosco	[n] - bois [n.m.sp]
boss	[n] - recensement [n]
botanica	[n] - botanique [adj.mf]
botanico	[adj] - botanique [adj.mf]
botteghino	[n] - guichet [n.m]
bottiglia	[n] - bouteille [n]
braccialetto	[n.m] - bracelet [n.m]
braccio	[n.f] - bras [n.m.sp]
braccio	[n] - bras [n.m.sp]
brache	[n] - pantalon [n]
bradipo	[n] - paresseux [adj.f]
branda	[n] - couchette [n]
brandello	[n] - étincelle [n]
brasiliano	[adj] - brésilien [adj]
brevetto	[n] - patent [adj.f]
brillare	[vblex] - briller [vblex]
brindare	[vblex] - trinquer [vblex]
britannico	[adj] - britannique [adj.mf]
broker	[n] - corridor [n.m]
bronzo	[n] - bronze [n]
browser	[n] - navigateur [adj]
bruscamente	[adv] - brusquement [adv]
brutale	[adj] - brutal [adj.f]
brutalmente	[adv] - brutalement [adv]
brutto	[adj] - laid [adj]
buco	[n] - creux [n.m.sp]
buddhismo	[n] - bouddhisme [n]
budget	[n] - budget [n]
bugia	[n] - mensonge [n.m]
bugiardo	[n] - menteur [n]
bulgaro	[adj] - bulgare [adj.mf]
bunker	[n] - bunker [n]
buono	[adj] - bon [adj]
buono	[adj] - riche [adj.mf]
burocratico	[adj] - bureaucratique [adj.mf]
burocrazia	[n] - bureaucratie [n]
bus	[n] - bus [n.m.sp]
buscare	[vblex] - chercher [vblex]
business	[n] - affaire [n]
bussola	[n] - boussole [n]
c'è bisogno	[vbmod] - falloir [vbmod]
cacare	[vblex] - chier [vblex]
caccia	[n] - chasse [n]
cacciare	[vblex] - chasser [vblex]
cacciatorpediniere	[n] - destructeur [adj]
caduta	[n] - chute [n]
caffè	[n] - café [n]
cagare	[vblex] - chier [vblex]
calamaro	[n] - calamar [n]
calamità	[n.f.sp] - calamité [n]
calare	[vblex] - caler [vblex]
calcare	[n] - chaux [n.f.sp]
calcestruzzo	[n] - béton [n]
calcio	[n] - coup de pied [n.m]
calcio	[n] - foot [n]
calcio	[n] - footballeur [n.f]
calcio di rigore	[n] - penalty [n]
calcolatore	[n] - calculateur [adj]
calcolatore	[n] - ordinateur [n.m]
calcolo	[n] - calcul [n]
calcolo infinitesimale	[n] - calcul [n]
caldo	[adj] - chaud [adj.f]
calendario	[n] - calendrier [n]
calendario	[n] - date [n]
calibrare	[vblex] - jauger [vblex]
caligine	[n] - brouillard [n.m]
callo	[n] - durillon [n]
calmare	[vblex] - calmer [vblex]
calore	[n] - chaleur [n.f]
calvo	[adj] - chauve [adj.mf]
calzino	[n] - chaussette [n.f]
cambiamento	[n] - saute [n.f]
cambiare	[vblex] - changer [vblex]
cambio	[n] - saute [n.f]
cambio	[n] - transmission [n]
cambio	[n] - trasmission [n]
camera	[n.f] - caméra [n]
camera	[n] - caméra [n]
camera	[n] - chambre [n.f]
camerata	[n] - camarade [n]
cameriere	[n] - garçon [n.m]
camicia	[n] - chemise [n]
camino	[n.m] - cheminée [n]
camino	[n] - chemin [n]
camino	[n] - sentier [n.m]
camino	[n] - sentier [n]
camion	[n] - camion [n]
camminare	[vblex] - cheminer [vblex]
cammino	[n.m] - chemin [n]
campagna	[n] - campagne [n]
campana	[n] - cloche [n]
campionamento	[n] - échantillonnage [n]
campionato	[n] - championnat [n]
campione	[n] - champion [n]
campione	[n] - exemple [n]
campione	[n] - échantillon [n.m]
campo	[n] - camp [n]
campus	[n] - campus [n]
canadese	[adj] - canadien [adj.f]
canale	[n] - chaîne [n.f]
canalizzazione	[n] - canalisation [n]
canarino	[n] - canarien [adj]
cancro	[n] - cancer [n]
candeggina	[n] - eau de javel [n]
candela	[n] - voile [n.f]
candidato	[n] - candidat [n]
cane	[n] - chien [n]
canis lupus familiaris	[n] - chien [n]
canna	[n] - roseau [n.m]
cannabis	[n] - marijuana [n]
cannone	[n] - canon [n]
canoa	[n] - canoë-kayak [n]
cantante	[n] - chanteur [n.f]
cantare	[vblex] - chanter [vblex]
canto	[n] - chant [n]
canzone	[n] - chanson [n]
caos	[n] - chaos [n]
cap	[n] - bonnet [n.m]
capacità	[n.f.sp] - habilité [n]
capanna	[n] - case [n]
capannone	[n] - bureau [n.m]
capannone	[n] - navire [n.m]
capello	[n] - cheveu [n]
capillare	[adj] - capillaire [adj]
capire	[vblex] - comprendre [vblex]
capitale	[adj] - capital [adj.f]
capitale	[n.mf] - capital [adj.f]
capitale	[n] - capital [adj.f]
capitalismo	[n] - capitalisme [n]
capitano	[n] - capitaine [n.mf]
capitolo	[n] - chapitre [n]
capo	[n.m] - gage [n.m]
capo	[n] - cap [n]
capo	[n] - chef [n.mf]
cappella	[n] - chapelle [n]
cappello	[n] - chapeau [n]
capra	[n] - chèvre [n]
captare	[vblex] - saisir [vblex]
captazione	[n] - captage [n.m]
caramella	[n] - bonbon [n]
carattere	[n] - caractère [n]
caratteristico	[adj] - caractéristique [adj.mf]
caratterizzare	[vblex] - caractériser [vblex]
carbone	[n] - charbon [n]
carbonio	[n] - carbone [n]
carburante	[n] - combustible [n]
carcassa	[n.f] - cadavre [n]
carcere	[n] - prison [n]
carciofo	[n] - artichaut [n.m]
cardinale	[n] - cardinal [n]
carente	[adj] - déficient [adj.f]
carestia	[n] - faim [n.f]
carica	[n] - charge [n.f]
carica elettrica	[n] - charge [n.f]
caricatura	[n] - caricature [n]
carico	[n] - charge [n.m]
carnale	[adj] - charnel [adj.f]
carne	[n] - chair [n]
caro	[adj] - cher [adj]
carpa	[n] - carpe [n]
carpentiere	[n] - menuisier [n]
carriera	[n] - carrière [n]
carro	[n] - char [n]
carrozza	[n.f] - fourgon [n]
carta	[n.f] - papier [n]
carta	[n] - carte [n]
carta	[n] - charte [n]
carta	[n] - papier [n]
cartina	[n] - carte [n.f]
casa	[n] - foyer [n.m]
casa	[n] - maison [n]
casco	[n] - coque [n.f]
casino	[n] - casino [n]
caso	[n.m] - confirmation [n]
caso	[n] - aléa [n]
caso	[n] - cas [n.m.sp]
castello	[n] - château [n]
castigare	[vblex] - punir [vblex]
castigliano	[adj] - castillan [adj]
castigliano	[n] - castillan [adj]
castrazione	[n] - castration [n]
casualmente	[adv] - accidentellement [adv]
casualmente	[adv] - fortuitement [adv]
catalano	[n] - catalan [adj]
catalogo	[n] - catalogue [n]
cataratta	[n] - chute [n]
catastale	[adj] - cadastral [adj.f]
catastrofe	[n] - catastrophe [n]
catastrofico	[adj] - catastrophique [adj.mf]
categoria	[n] - catégorie [n]
categoricomente	[adv] - catégoriquement [adv]
catrame	[n] - goudron [n]
cattedrale	[n] - cathédrale [n]
cattedrale	[n] - siège [n.m]
cattivo	[adj] - mauvais [adj.f]
cattolico	[adj] - catholique [adj.mf]
catturare	[vblex] - capturer [vblex]
causa	[n] - cause [n]
causare	[vblex] - causer [vblex]
cautelare	[vblex] - abriter [vblex]
cava	[n] - carrière [n]
cava	[n] - cave [n]
cavaliere	[n] - cavalier [n]
cavalleria	[n] - cavalerie [n]
cavallo	[n] - cheval [n]
caverna	[n] - grotte [n]
caviglia	[n] - cheville [n.f]
cavità	[n.f.sp] - cavité [n]
cavo	[n] - câble [n]
cavolo	[n.m] - chou [n.m]
cavolo	[n] - chou [n.m]
ce	[vblex.pri.p3.pl] - y avoir [vblex]
ce	[vblex.pri.p3.sg] - y avoir [vblex]
cedere	[vblex] - céder [vblex]
celebrare	[vblex] - célébrer [vblex]
celebrazione	[n] - celebration [n]
celebre	[adj] - célèbre [adj]
celebrità	[n.f.sp] - célébrité [n]
celibato	[n] - célibat [n]
cellula	[n] - cellule [n]
cellulare	[adj] - cellulaire [adj]
cena	[n] - dîner [n.m]
cenare	[vblex] - dîner [vblex]
censimento	[n] - recensement [n]
censura	[n] - censure [n]
centimetro	[n] - centimètre [n]
centinaio	[n.f] - centaine [n.f]
cento	[num] - cent [num]
centrale	[adj] - central [adj.f]
centrale	[n] - central [adj.f]
centrare	[vblex] - centrer [vblex]
centro	[n] - centre [n]
centro	[n] - noyau [n]
centrocampista	[n] - demi-centre [n]
ceppo	[n.m] - souche [n]
cera	[n] - cire [n]
ceramica	[n.f] - vase [n]
ceramica	[n] - céramique [n]
cercado	[n] - clos [n.m.sp]
cercare	[vblex] - chercher [vblex]
cerchio	[n] - cercle [n]
cerebrale	[adj] - cérébral [adj.f]
certamente	[adv] - bien sûr [adv]
certamente	[adv] - précisément [adv]
certamente	[adv] - sûr [adj]
certificare	[vblex] - certifier [vblex]
certificato	[n] - certificat [n]
certificazione	[n] - certification [n]
certo	[det.ind] - vrai [adv]
cervello	[n] - cerveau [n]
cessare	[vblex] - cesser [vblex]
cessione	[n] - cession [n]
cesta	[n] - corbeille [n]
cesto	[n] - corbeille [n.f]
champagne	[n] - champagne [n]
chat	[n] - chat [n.m]
che	[cnjsub] - que [cnjsub]
che	[n] - argot [n]
che	[prn] - quel [adj.itg.f.pl]
chef	[n] - cuisinier [n]
chi	[prn.itg.mf.sp] - qui est-ce qui [prn.itg.mf.sp]
chiappa	[n] - fesse [n]
chiaramente	[adv] - clairement [adv]
chiaro	[adj] - clair [adj]
chiaro	[n] - clair [adj]
chiave	[n] - clef [adj]
chiave	[n] - clef [n]
chiedere	[vblex] - demander [vblex]
chiesa	[n] - église [n]
chilogrammo	[n] - kg [n]
chilogrammo	[n] - kilogramme [n]
chilometro	[n] - kilomètre [n]
chilometro	[n] - km [n]
chimera	[n] - chimère [n]
chimica	[n] - chimique [adj.mf]
chimico	[adj] - chimique [adj.mf]
chimico	[n] - chimique [adj.mf]
chiodo	[n] - clou [n]
chiosco	[n] - kiosque [n]
chip	[n] - puce [n.f]
chirurgia	[n] - chirurgie [n]
chirurgo	[n] - chirurgien [n]
chitarra	[n] - guitare [n]
chitarra	[n] - guitariste [n]
chiusura	[n] - clôture [n]
châssis	[n] - châssis [n]
ci	[prn.pro.adv] - y [prn.enc.adv]
ci	[prn.pro] - nous [prn]
ciao	[n] - au revoir [ij]
ciarla	[n] - bavardage [n.m]
ciascuno	[det.ind.f] - chaque [det]
ciascuno	[det.ind.m] - chaque [det]
ciascuno	[prn] - chacun [prn]
ciclismo	[n] - cyclisme [n]
ciclismo	[n] - cycliste [adj]
ciclista	[n.m] - cycliste [adj]
ciclista	[n] - cycliste [adj]
ciclo	[n] - cycle [n]
ciclone	[n] - cyclone [n]
cieco	[n] - aveugle [adj.mf]
cielo	[n] - ciel [n]
cifra	[n] - chiffre [n]
cifrare	[vblex] - chiffrer [vblex]
ciglia	[n] - cil [n.m]
cile	[n] - chilien [adj]
cimitero	[n] - cimetière [n]
cinema	[n] - cinéma [n]
cinematografico	[adj] - cinématographique [adj.mf]
cingere	[vblex] - ceindre [vblex]
cinquanta	[num] - cinquante [num]
cinquantacinque	[num] - cinquante-cinq [num]
cinquantadue	[num] - cinquante-deux [num]
cinquantanove	[num] - cinquante-neuf [num]
cinquantaquattro	[num] - cinquante-quatre [num]
cinquantasei	[num] - cinquante-six [num]
cinquantasette	[num] - cinquante-sept [num]
cinquantatré	[num] - cinquante-trois [num]
cinquantesimo	[adj] - cinquantième [adj.mf]
cinquantotto	[num] - cinquante-huit [num]
cinquantuno	[num] - cinquante et un [det]
cinque	[num] - cinq [num]
cintura	[n.f] - ceinture [n.f]
cioccolato	[n.m] - réseau [n.m]
cioccolato	[n] - chocolat [n.m]
cipolla	[n] - oignon [n.m]
circa	[adv] - approchant [adv]
circa	[adv] - autour [adv]
circa	[pr] - sur [pr]
circo	[n] - cirque [n]
circolare	[vblex] - circulaire [adj]
circolo	[n] - cercle [n]
circondare	[vblex] - cercler [vblex]
circoscrizione	[n] - circonscription [n]
circuito	[n] - circuit [n]
circuito integrato	[n] - micropuce [n.f]
circuito integrato	[n] - puce [n.f]
ciste	[n.f] - kyste [n]
cisterna	[n] - citerne [n]
cisti	[n] - kyste [n]
citare	[vblex] - citer [vblex]
citazione	[n] - rendez-vous [n.m.sp]
citrus × limon	[n] - citron [n]
cittadino	[n] - citoyen [n]
città	[n.f.sp] - cité [n]
città	[n] - ville [n.f]
civile	[adj] - civil [adj.f]
civiltà	[n.f.sp] - civilisation [n]
ciò nonostante	[cnjadv] - cependant [adv]
ciò nonostante	[cnjadv] - et encore [adv]
clandestino	[adj] - clandestin [adj]
classe	[n] - classe [n]
classificazione	[n] - classement [n.m]
clausula	[n] - clause [n]
cliché	[n] - cliché [n]
cliente	[n.mf] - client [n]
cliente	[n] - client [n]
clientela	[n] - clientèle [n]
clima	[n] - météo [n.f.sp]
climatico	[adj] - climatique [adj.mf]
clown	[n] - clown [n]
club	[n] - club [n]
cocaina	[n] - cocaïne [n]
coccinella	[n] - coccinelle [n]
cocktail	[n] - cocktail [n]
coda	[n] - queue [n.f]
codesto	[prn.tn.nt] - cela [prn]
codice	[n.m] - clef [adj]
codice	[n] - code [n]
coefficiente binomiale	[n] - combinaison [n]
coerente	[adj] - cohérent [adj.f]
coesione	[n] - cohésion [n]
cognitivo	[adj] - cognitif [adj]
cognome	[n] - lignée [n.f]
col fine di	[cnjadv] - afin que [cnjadv]
colazione	[n] - petit déjeuner [n]
colera	[n] - colère [n.f]
collaborazione	[n] - partenariat [n.m]
collaborazionismo	[n] - collaboration [n]
collana	[n] - collier [n]
collante	[n] - lien [n]
collaterale	[adj] - collatéral [adj.f]
collegamento ipertestuale	[n] - lien [n]
collegiale	[adj] - écolier [n]
collegiale	[n.mf] - écolier [n]
collezione	[n] - collection [n]
collezionista	[n.m] - collectionneur [adj.f]
collezionista	[n] - collectionneur [adj.f]
collina	[n] - colline [n.f]
collina	[n] - colline [n]
collisione	[n] - collision [n]
collo	[n] - encolure [n.f]
collocare	[vblex] - caser [vblex]
colloquiale	[adj] - familier [adj.f]
colmare	[vblex] - satisfaire [vblex]
colmo	[n] - comble [n.m.sg]
colombia	[n] - colombien [adj]
colonia	[n] - colonie [n]
colonna	[n] - colonne [n]
colonnello	[n] - colonel [n.f]
colore	[adv] - couleur [n.f]
colore	[n] - couleur [n.f]
colossal	[adj] - colossal [adj.f]
colpevole	[adj] - coupable [adj.mf]
colpire	[vblex] - frapper [vblex]
colpo	[n] - coup [n]
coltello	[n] - couteau [n]
coltivare	[vblex] - cultiver [vblex]
coltivazione	[n] - culture [n.f]
colto	[adj] - culte [n]
colto	[n] - culte [n]
colui	[prn.tn.p3.f] - ce [det.dem.mf.pl]
colui	[prn.tn.p3.mf] - ce [det.dem.mf.pl]
colui	[prn.tn.p3.m] - ce [det.dem.mf.pl]
columbidae	[n] - pigeon [n]
comandare	[vblex] - commander [vblex]
comarca	[n] - région [n]
combattente	[n.m] - activiste [n]
combattere	[vblex] - bagarrer [vblex]
combinare	[vblex] - combiner [vblex]
combustibile	[n] - combustible [n]
come	[adv] - aussi bien que [cnjadv]
come	[adv] - comment [adv]
come	[cnjadv] - de même que [cnjadv]
come	[pr] - aussi bien que [cnjadv]
come per esempio	[adv] - comme par exemple [adv]
come se	[adv] - comme si [cnjadv]
comico	[n] - comique [n.mf]
cominciare	[vblex] - commencer [vblex]
comitato	[n] - comité [n]
comitato	[n] - junte [n]
commedia	[n] - comique [n.mf]
commedia	[n] - comédie [n]
commerciale	[adj] - commercial [adj.f]
commercializzazione	[n] - commercialisation [n]
commerciante	[adj] - commerçant [n.f]
commerciante	[n] - commerçant [n.f]
commercio	[n] - commerce [n]
commesso	[n] - dépendant [adj.f]
committente	[n] - acheteur [n]
comodamente	[adv] - confortablement [adv]
compagine	[n] - organisation [n]
compagno	[n] - collègue [n.mf]
compagno	[n] - mari [n]
compagno	[n] - époux [n.f]
comparazione	[n] - comparaison [n]
compatibile	[adj] - compatible [adj]
compensare	[vblex] - compenser [vblex]
compensazione	[n] - compensation [n]
competenza	[n] - compétence [n]
competitività	[n.f.sp] - compétitivité [n]
compimento	[n] - accomplissement [n]
compleanno	[n] - anniversaire [n.m.ND]
complemento	[n] - complément [n]
complemento di argomento	[n] - supplément [n]
complesso	[adj] - complexe [adj.mf]
complesso	[n] - complexe [adj.mf]
completamente	[adv] - clairement [adv]
completamente	[adv] - complètement [adv]
completare	[vblex] - compléter [vblex]
complicare	[vblex] - compliquer [vblex]
complice	[n] - complice [n]
componente	[n.mf] - composant [n]
comportamento	[n] - comportement [n]
comportamento	[n] - conduite [n.f]
comportare	[vblex] - comporter [vblex]
compositore	[adj] - compositeur [n]
compositore	[n] - compositeur [n]
composizione	[n] - composition [n]
comprare	[vblex] - acheter [vblex]
compratore	[n] - acheteur [n]
comprendere	[vblex] - comprendre [vblex]
comprensione	[n] - compréhension [n]
compressione	[n] - compression [n]
compromesso	[n] - compromis [n.m.sp]
computer	[n.m.pl] - ordinateur [n]
computer	[n.m.sp] - ordinateur [n]
computer	[n] - ordinateur [n.m]
computer portatile	[n] - portable [adj]
comune	[adj] - commun [adj.f]
comune	[n] - commun [adj.f]
comune	[n] - mairie [n.f]
comunicare	[vblex] - communiquer [vblex]
comunicazione	[n] - communication [n]
comunismo	[n] - communisme [n]
comunista	[n] - communiste [adj]
comunità	[n.f.sp] - communauté [n]
con	[pr] - avec [pr]
con attenzione	[adv] - soigneusement [adv]
con grandi difficoltà	[adv] - à grand-peine [adv]
con me	[prn] - avec moi [prn.tn]
con se	[prn] - avec soi [prn.tn]
con te	[prn] - avec toi [prn.tn]
concedere	[vblex] - accorder [vblex]
concentrare	[vblex] - concentrer [vblex]
concentrazione	[n] - rassemblement [n.m]
concepción	[n] - conception [n.m]
concertare	[vblex] - concerter [vblex]
concerto	[n] - concert [n]
concerto	[n] - récital [n]
concessione	[n] - concession [n]
concetto	[n] - concept [n]
concezione	[n.f] - création [n.f]
conchiglia	[n] - coquille [n]
conciliazione	[n] - conciliation [n]
concludere	[vblex] - conclure [vblex]
concordare	[vblex] - concorder [vblex]
concorrenza	[n] - compétence [n]
concorso	[n.m] - assistance [n]
concorso	[n] - concours [n.m.sp]
concorso	[n] - opposition [n]
concretamente	[adv] - concrètement [adv]
concretare	[vblex] - concrétiser [vblex]
condanna	[n] - condamnation [n]
condannare	[vblex] - condamner [vblex]
condividere	[vblex] - partager [vblex]
condizione	[n] - condition [n]
condotto	[n] - conduit [n]
conduttore	[n] - conducteur [adj]
confederazione	[n] - confédération [n]
conferenza	[n] - assise [n]
conferire	[vblex] - conférer [vblex]
confermare	[vblex] - confirmer [vblex]
confermazione	[n] - confirmation [n]
confessione	[n] - aveu [n.m]
configurazione	[n] - configuration [n]
conflitto	[n] - altercation [n.f]
conflitto	[n] - conflit [n]
conflittuale	[adj] - conflictuel [adj]
confluire	[vblex] - confluer [vblex]
confondere	[vblex] - confondre [vblex]
conformare	[vblex] - conformer [vblex]
conforme	[adj] - accord [n]
conformità	[n.f.sp] - conformité [n]
confrontare	[vblex] - confronter [vblex]
confronto	[n.m] - comparaison [n]
congedo	[n.m] - congé [n.m]
congelamento	[n] - congélation [n]
congelare	[vblex] - geler [vblex]
congelare	[vblex] - glacer [vblex]
congettura	[n] - conjecture [n]
congiuntamente	[adv] - conjointement [adv]
congiunzione	[n] - conjonction [n]
congratulazioni	[n] - félicitation [n]
congregare	[vblex] - rassembler [vblex]
congresso	[n] - congrès [n.m.sp]
coniglio	[n] - lapin [n]
coniugale	[adj] - conjugal [adj.f]
coniuge	[n] - conjoint [n.f]
connessione	[n] - connexion [n]
connettere	[vblex] - relier [vblex]
cono	[n] - cône [n]
conoscenza	[n] - connaissance [n.f]
conoscenza	[n] - savoir [n]
conoscere	[vblex] - connaître [vblex]
conquista	[n] - conquête [n]
conquistare	[vblex] - conquérir [vblex]
consacrare	[vblex] - adonner [vblex]
consapevole	[adj] - conscient [adj.f]
consapevolezza	[n] - conscience [n]
conseguente	[adj] - conséquent [adj.f]
conseguimento	[n.m] - réussite [n]
conseguimento	[n] - obtention [n]
conseguimento	[n] - réussite [n]
consenso	[n] - approbation [n]
consenso	[n] - consensus [n.m.sp]
consentire	[vblex] - consentir [vblex]
conservare	[vblex] - conserver [vblex]
conservatore	[adj] - conservateur [adj]
conservazione	[n] - conservation [n]
considerare	[vblex] - considérer [vblex]
considerazione	[n] - égard [n.m]
considerevolmente	[adv] - considérablement [adv]
consigliabile	[adj] - conseillable [adj]
consigliare	[vblex] - conseiller [vblex]
consigliere	[n.m] - conseiller [n]
consiglio	[n] - conseil [n]
consistere	[vblex] - consister [vblex]
consolare	[vblex] - consoler [vblex]
console	[n] - console [n]
console	[n] - consul [n]
consolidamento	[n.m] - consolidation [n]
consolidare	[vblex] - consolider [vblex]
consonante laterale	[n] - latéral [adj.f]
consorzio	[n] - consortium [n]
constatare	[vblex] - constater [vblex]
consulente	[n] - consultant [n]
consulenza	[n.f] - conseil [n]
consulenza	[n] - conseil [n]
consulenza	[n] - consultation [n]
consultare	[vblex] - consulter [vblex]
consultivo	[adj] - consultatif [adj]
consumare	[vblex] - consumer [vblex]
consumatore	[n] - consommateur [n]
consumo	[n] - consommation [n.f]
contabilità	[n.f.sp] - comptabilité [n]
contact	[n] - contact [n]
contadino	[n] - paysan [n]
container	[n] - conteneur [n]
contaminare	[vblex] - contaminer [vblex]
contaminazione	[n] - contamination [n]
contare	[vblex] - compter [vblex]
contatore	[n] - compteur [n.m]
contemplare	[vblex] - contempler [vblex]
contemporaneamente	[adv] - à la fois [adv]
contenere	[vblex] - contenir [vblex]
contenitore	[n] - conteneur [n]
contento	[adj] - content [adj]
contenzioso	[adj] - contentieux [adj.f]
contenzioso	[n] - contentieux [adj.f]
contenzioso	[n] - procès [n.m.sp]
contestare	[vblex] - répondre [vblex]
continentale	[adj] - continental [adj.f]
continente	[n] - contenant [n]
contingente	[n.mf] - contingent [adj.f]
continuamente	[adv] - constamment [adv]
continuare	[vblex] - continuer [vblex]
continuare	[vblex] - poursuivre [vblex]
continuo	[adj] - continu [adj]
conto	[n] - compte [n.m]
contorno	[n] - contour [n]
contraccettivo	[adj] - contraceptif [adj]
contraddittorio	[adj] - contradictoire [adj.mf]
contraddizione	[n] - contradiction [n]
contrapposizione	[n] - confrontation [n]
contrario	[adj] - contraire [adj.mf]
contrastare	[vblex] - contraster [vblex]
contratto	[n] - contrat [n]
contrattuale	[adj] - contractuel [adj.f]
contribuente	[n] - contribuable [adj]
contribuire	[vblex] - contribuer [vblex]
contributo	[n.m] - contribution [n]
contro	[n] - contre [n.m]
contro	[pr] - contre [n.m]
controllare	[vblex] - contrôler [vblex]
controllo	[n.m] - audit [n.m]
controllo	[n] - contrôle [n]
controverso	[adj] - controversé [adj]
convalidare	[vblex] - valider [vblex]
convenzionale	[adj] - conventionnel [adj.f]
convenzione	[n.f] - convention [n.f]
convenzione	[n] - convention [n.f]
convenzione	[n] - convention [n]
conversare	[vblex] - discuter [vblex]
conversazione	[n] - conversation [n]
convertibile	[adj] - convertible [adj]
convertire	[vblex] - convertir [vblex]
convincente	[adj] - convaincant [adj.f]
convincere	[vblex] - convaincre [vblex]
convocare	[vblex] - convoquer [vblex]
cooperazione	[n] - partenariat [n.m]
coordinamento	[n.m] - coordination [n]
coordinare	[vblex] - coordonner [vblex]
coordinazione	[n] - coordination [n]
coperchio	[n.m] - couvercle [n.m]
coperta	[n] - couverture [n]
copertina	[n] - cape [n]
copertina	[n] - couverture [n]
copertura	[n] - réseau [n.m]
copia	[n] - copie [n]
coprire	[vblex] - couvrir [vblex]
copyright	[n] - copyright [n]
coraggio	[n] - courage [n]
coraggio	[n] - valeur [n.f]
corale	[adj] - choral [adj.f]
corda	[n] - corde [n]
cordiale	[adj] - cordial [adj.f]
coreano	[n] - coréen [adj]
coreografia	[n] - chorégraphie [n]
cornice	[n] - corniche [n]
coro	[n] - choral [adj.f]
coro	[n] - coeur [n]
corona	[n] - couronne [n]
corpo	[n.m] - masse [n]
corpo	[n] - corps [n.m.sp]
corporazione	[n] - corps de métier [n.m.sp]
correggere	[vblex] - corriger [vblex]
corrente	[n] - courant [adj.f]
correre	[vblex] - courir [vblex]
correttamente	[adv] - correctement [adv]
correttamente	[adv] - dûment [adv]
corretto	[adj] - correct [adj]
corridoio	[n] - corridor [n.m]
corridoio	[n] - couloir [n]
corriere	[n] - messager [n]
corruzione	[n] - corruption [n]
corsia di emergenza	[n] - accotement [n]
corteccia	[n] - couche [n]
corteggiamento	[n] - cortège [n]
cortile	[n] - cour [n.f]
cortocircuito	[n] - court-circuit [n]
cortometraggio	[n] - court-métrage [n]
cosa	[n] - chose [n]
cosa	[prn] - quel [adj.itg.f.pl]
cosciente	[adj] - conscient [adj.f]
coscienza	[n] - conscience [n]
coscienza	[n] - esprit [n]
costa	[n] - côte [n]
costa	[n] - littoral [n]
costantemente	[adv] - constamment [adv]
costare	[vblex] - coûter [vblex]
costellazione	[n] - constellation [n]
costituente	[adj] - constituant [adj.f]
costituzionale	[adj] - constitutionnel [adj.f]
costituzionalmente	[adv] - constitutionnellement [adv]
costituzione	[n] - constitution [n]
costo	[n] - coût [n]
costo	[n] - dépense [n.f]
costola	[n] - côtelette [n]
costoso	[adj] - coûteux [adj.f]
costruire	[vblex] - bâtir [vblex]
costruttivo	[adj] - constructif [adj]
costui	[prn.tn.p3.f] - ce [det.dem.mf.pl]
costui	[prn.tn.p3.mf] - ce [det.dem.mf.pl]
costui	[prn.tn.p3.m] - ce [det.dem.mf.pl]
così	[adj] - tel [adj.f]
così	[adv] - ainsi [adv]
così come	[adv] - ainsi que [cnjadv]
cotoletta	[n] - côtelette [n]
cravatta	[n] - cravate [n]
creare	[vblex] - créer [vblex]
creatività	[n.f.sp] - créativité [n]
creativo	[adj] - créatif [adj]
creatura	[n] - créature [n]
creazione	[n] - création [n]
credenza	[n] - garde-manger [n.m]
credenza	[n] - étalage [n]
credere	[vblex] - croire [vblex]
credito	[n] - crédit [n]
crema	[n] - crème [n]
crepa	[n] - fissure [n]
crepaccio	[n] - crevasse [n]
crepuscolo	[n] - crépuscule [n]
crescente	[adj] - croissant [adj.f]
crescere	[vblex] - croître [vblex]
crescita	[n] - croissance [n.f]
cresta	[adj] - dorsal [adj.f]
criminale	[adj] - criminel [adj.f]
crimine	[n] - crime [n]
criniera	[n] - chevelure [n]
cristallo	[n] - vitre [n.f]
cristianesimo	[n] - chrétien [adj]
cristiano	[n] - chrétien [adj]
criticare	[vblex] - critiquer [vblex]
critico	[adj] - critique [adj.mf]
critico	[n] - critique [adj.mf]
croce	[n] - croix [n.f.sp]
crociera	[n] - croisière [n.f]
cronaca	[n] - chronique [n]
cronico	[adj] - chronique [adj.mf]
cronologia	[n] - chronologie [n]
cronologico	[adj] - chronologique [adj.mf]
cronometro	[n] - chronomètre [n]
cruciale	[adj] - crucial [adj.f]
crudele	[adj] - cruel [adj.f]
cruna	[n] - oeil [n]
cubano	[adj] - cubain [adj]
cubismo	[n] - cubisme [n]
cubo	[n] - seau [n]
cucina	[n] - cuisine [n]
cucinare	[vblex] - cuisiner [vblex]
cucire	[vblex] - coudre [vblex]
cui	[prn.itg.mf.sp] - qui est-ce qui [prn.itg.mf.sp]
culminare	[vblex] - terminer [vblex]
culo	[n] - cul [n]
culto	[n] - culte [n]
cultura	[n] - culture [n.f]
culturale	[adj] - culturel [adj.f]
cumulo	[n.m] - accumulation [n]
cuneo	[n] - cale [n]
cuoco	[n] - cuisinier [n]
cuoio	[n] - cuir [n]
cuore	[n] - coeur [n]
cupola	[n] - dôme [n.m]
cupressus	[n] - cyprès [n.m.sp]
cura	[n.f] - soin [n.m]
cura	[n] - attention [n]
cura	[n] - soin [n.m]
curare	[vblex] - guérir [vblex]
curdi	[n] - kurde [adj.mf]
curdo	[n] - kurde [adj.mf]
curiosamente	[adv] - curieusement [adv]
curioso	[adj] - curieux [adj.f]
curva	[n] - courbe [n]
custode	[n.mf] - gardien [n]
custodia	[n.f] - avoir [n]
cyprinus carpio	[n] - carpe [n]
d	[n] - d [n.m]
d'altra parte	[adv] - d'autre part [adv]
d'altro lato	[adv] - d'autre part [adv]
d'ogni modo	[adv] - dans tous les cas [adv]
d'ora in avanti	[adv] - d'ores et déjà [adv]
d'ora in poi	[adv] - d'ores et déjà [adv]
da	[n] - de [pr]
da	[pr] - de [pr]
da	[pr] - depuis [pr]
da allora	[adv] - depuis lors [adv]
da parte	[adv] - à part [adv]
da quando	[adv] - depuis que [cnjadv]
da un lato	[adv] - d'une part [adv]
dal momento che	[adv] - depuis que [cnjadv]
dama	[n] - dame [n]
danese	[adj] - danois [adj.f]
danza	[n] - danse [n.f]
dappertutto	[adv] - partout dans le monde [adv]
dare	[vblex] - donner [vblex]
dato	[n] - donnée [n.f]
daucus carota	[n] - carotte [n]
davanti	[adv] - devant [adv]
davanti	[pr] - devant [pr]
davanti a	[pr] - devant [pr]
de	[n] - de [pr]
debilitare	[vblex] - affaiblir [vblex]
debitamente	[adv] - dûment [adv]
debito	[n.m] - dette [n.f]
debole	[adj] - faible [adj]
debolezza	[n] - faiblesse [n]
debugging	[n] - dépuration [n]
debut	[n] - début [n]
decantazione	[n] - décantation [n]
decennio	[n] - décennie [n.m]
decidere	[vblex] - décider [vblex]
decisione	[n] - décision [n]
decisivo	[adj] - décisif [adj]
declassamento	[n.m] - disqualification [n]
decomposizione	[n] - décomposition [n]
decretare	[vblex] - décréter [vblex]
dedicare	[vblex] - consacrer [vblex]
deficiente	[adj] - déficient [adj.f]
definire	[vblex] - définir [vblex]
definitivamente	[adv] - définitivement [adv]
definitivo	[adj] - définitif [adj]
definizione	[n] - définition [n]
degnamente	[adv] - dignement [adv]
degno	[adj] - digne [adj.mf]
degradante	[adj] - dégradant [adj.f]
degradare	[vblex] - dégrader [vblex]
degradazione	[n.f] - aggravation [n.f]
degradazione	[n] - dégradation [n]
degustare	[vblex] - déguster [vblex]
delegare	[vblex] - déléguer [vblex]
deliberatamente	[adv] - exprès [adv]
delineare	[vblex] - profiler [vblex]
delinquenza	[n] - délinquance [n]
delizioso	[adj] - délicieux [adj.f]
delusione	[n] - désappointement [n.m]
democraticamente	[adv] - démocratiquement [adv]
democratico	[adj] - démocratique [adj.mf]
democrazia	[n] - démocratie [n]
demografia	[n] - démographie [n]
demolizione	[n] - démolition [n]
demone	[n] - démon [n]
denaro	[n] - argent [n.m.sg]
denominazione	[n.f] - nom [n]
denominazione	[n] - dénomination [n]
denotare	[vblex] - dénoter [vblex]
densità	[n.f.sp] - densité [n]
dente	[n] - dent [n.f]
dentista	[n] - dentiste [n]
dentro	[adv] - dedans [adv]
dentro	[adv] - à dedans [adv]
dentro	[pr] - dedans [adv]
denuncia	[n] - dénonciation [n]
denunciare	[vblex] - dénoncer [vblex]
depositare	[vblex] - déposer [vblex]
deposito	[n] - avoir [n]
depressione	[n] - dépression [n]
deprezzamento	[n] - amortissement [n.m]
depurare	[vblex] - épurer [vblex]
depurazione	[n] - dépuration [n]
deputato	[n] - député [n]
derivare	[vblex] - dériver [vblex]
descrizione	[n] - signalement [n.m]
deserto	[n] - désert [adj]
desiderio	[n] - désir [n]
desiderio	[n] - désirer [vblex]
design	[n] - création [n.f]
designare	[vblex] - désigner [vblex]
desistere	[vblex] - départir [vblex]
dessert	[n] - dessert [n]
destinare	[vblex] - destiner [vblex]
destinare	[vblex] - réserver [vblex]
destinatario	[adj.m] - destinataire [adj.mf]
destinazione	[n.f] - destination [n.f]
destinazione	[n] - destination [n.f]
destino	[n] - destination [n.f]
destituzione	[n] - destitution [n]
destra	[adj] - droite [n]
destra	[n] - droite [n]
detenere	[vblex] - arrêter [vblex]
deterioramento	[n] - dégât [n]
determinante	[adj] - déterminant [adj.f]
determinare	[vblex] - déterminer [vblex]
determinazione	[n] - détermination [n]
devoluzione	[n] - décentralisation [n]
devozione	[n] - adoration [n]
devozione	[n] - dévouement [n.m]
di	[pr] - de [pr]
di fatto	[adv] - en fait [adv]
di fretta	[adv] - à des marches forcées [adv]
di fronte	[adv] - devant [adv]
di mattina	[adv] - le jour [adv]
di meno	[adv] - moins [adv]
di notte	[adv] - la nuit [adv]
di quando in quando	[adv] - de temps en autre [adv]
di recente	[adv] - récemment [adv]
di tanto in tanto	[adv] - de temps en temps [adv]
diagnosi	[n] - diagnostic [n]
diagnosticare	[vblex] - diagnostiquer [vblex]
dialogare	[vblex] - dialoguer [vblex]
dialogo	[n] - dialogue [n]
diamante	[n] - diamant [n]
diario	[n] - quotidien [adj]
diarrea	[n] - diarrhée [n]
diavolo	[n] - diable [n]
dibattito	[n] - débat [n]
dicembre	[n.m.pl] - décembre [n]
dicembre	[n.m.sp] - décembre [n]
dicembre	[n] - décembre [n]
dichiarazione	[n] - declaration [n]
diciannove	[num] - dix-neuf [num]
diciannovesimo	[adj] - dix-neuvième [adj.mf]
diciassette	[num] - dix-sept [num]
diciassettesimo	[adj] - dix-septième [adj.mf]
diciottesimo	[adj] - dix-huitième [adj.mf]
diciotto	[num] - dix-huit [num]
dieci	[num] - dix [num]
dieci comandamenti	[n] - commandement [n]
dieta	[n] - diète [n]
dietro	[adv] - derrière [adv]
dietro	[pr] - après [pr]
dietro	[pr] - derrière [adv]
dietro	[pr] - derrière [pr]
difendere	[vblex] - abriter [vblex]
difendere	[vblex] - défendre [vblex]
difesa	[n] - défense [n]
difetto	[n] - défaut [n]
diffamazione	[n] - diffamation [n]
differente	[adj] - différent [adj.f]
differenza	[n] - différence [n]
difficile	[adj] - difficile [adj]
difficilmente	[adv] - difficilement [adv]
difficoltà	[n.f.sp] - difficulté [n]
diffidenza	[n] - défiance [n]
diffusione	[n] - diffusion [n]
diga	[n] - digue [n.f]
digestione	[n] - digestion [n]
digitale	[adj] - digital [adj.f]
dignità	[n.f.sp] - dignité [n]
dimensione	[n.f] - taille [n.f]
dimensione	[n] - dimension [n]
dimettersi	[vblex] - démissionner [vblex]
diminuire	[vblex] - diminuer [vblex]
diminuzione	[n] - diminution [n]
dimostrare	[vblex] - démontrer [vblex]
dimostrazione	[n] - démonstration [n]
dinamico	[adj] - dynamique [adj.mf]
dinanzi a	[pr] - devant [pr]
dinosauri	[n] - dinosaure [n]
dinosauro	[n] - dinosaure [n]
dio	[n] - dieu [n]
dipartimento	[n] - département [n]
dipendente	[adj] - dépendant [adj.f]
dipendente	[adj] - intoxiqué [n]
dipendente	[n.mf] - intoxiqué [n]
dipendente	[n] - dépendant [adj.f]
dipendenza	[n] - dépendance [n]
dipendere	[vblex] - dépendre [vblex]
diploma	[n] - diplôme [n]
diplomatico	[adj] - diplomatique [adj.mf]
diplomatico	[n] - diplomatique [adj.mf]
diplomazia	[n] - diplomatie [n]
diramazione	[n.f] - embranchement [n]
dire	[n] - dire [vblex]
directory	[n] - directoire [n]
direttamente	[adv] - directement [adv]
direttore	[n] - directeur [n]
direttrice	[n] - directive [n]
direzione	[n] - adresse [n]
dirigere	[vblex] - adresser [vblex]
diritto	[adj] - droit [adj]
diritto	[n.m] - législation [n]
diritto	[n] - droit [adj]
diritto	[n] - loi [n]
disabile	[n] - déficient [adj.f]
disastro	[n] - catastrophe [n]
disastro	[n] - désastre [n.m]
disco	[n.mf] - disque [n]
disco	[n] - disque [n]
discoteca	[n] - boîte [n]
discreto	[adj] - discret [adj]
discriminare	[vblex] - discriminer [vblex]
discriminatorio	[adj] - discriminatoire [adj.mf]
discriminazione	[n] - discrimination [n]
discussione	[n] - discussion [n]
discutibile	[adj] - contestable [adj]
disegnare	[vblex] - dessiner [vblex]
disegno	[n] - création [n.f]
disegno	[n] - dessin [n]
disgelo	[n] - fonte [n.f]
disgraziatamente	[adv] - malheureusement [adv]
disidratazione	[n] - déshydratation [n]
disinfezione	[n] - désinfection [n]
dislocazione	[n] - dislocation [n]
disoccupazione	[n.f] - chômage [n]
disoccupazione	[n] - chômage [n]
disoccupazione	[n] - chômeur [n]
disonestamente	[adv] - légèrement [adv]
disordine	[n] - désordre [n]
dispari	[adj.mf.sp] - impair [n.f]
dispensare	[vblex] - dispenser [vblex]
dispersione	[n] - dispersion [n]
disponibile	[adj] - disponible [adj]
disponibilità	[n.f.sp] - disponibilité [n]
dispositivo	[adj] - dispositif [adj]
dispositivo	[n] - dispositif [adj]
disposizione	[n] - allant [n.m]
disputare	[vblex] - disputer [vblex]
disseminazione	[n] - dissémination [n]
dissidente	[n] - dissident [adj.f]
dissimulare	[vblex] - dissimuler [vblex]
dissoluzione	[n] - dissolution [n]
distante	[adj] - distant [adj.f]
distanza	[n] - distance [n]
distintivo	[n] - distinctif [adj]
distorsione	[n] - foulure [n.f]
distribuire	[vblex] - distribuer [vblex]
distributore	[adj] - dépensier [adj]
distributore	[n] - station-service [n]
distribuzione	[n] - distribution [n]
distruggere	[vblex] - détruire [vblex]
disturbo	[n] - gêne [n]
disuguale	[adj] - inégal [adj.f]
dito	[n.f] - doigt [n]
dito	[n] - doigt [n]
dittatore	[n] - dictateur [n]
dittatura	[n] - dictateur [n]
dittatura	[n] - dictature [n]
diurno	[adj] - diurne [adj.mf]
diversità	[n.f.sp] - diversité [n]
diverso	[det.ind] - divers [adj.f]
divertimento	[n] - amusement [n.m]
divertir	[vblex] - amuser [vblex]
dividere	[vblex] - diviser [vblex]
divieto	[n.m] - déclaration d'inhabilité [n]
divieto	[n.m] - interdiction [n]
divinità	[n.f.sp] - divinité [n]
divisa	[n] - devise [n]
divisa	[n] - uniforme [adj]
divisione	[n] - division [n]
divorare	[vblex] - dévorer [vblex]
divorzio	[n] - divorce [n]
divulgare	[vblex] - divulguer [vblex]
divulgativo	[adj] - vulgarisateur [adj]
dizionario	[n] - dictionnaire [n]
doccia	[n] - douche [n]
documentale	[adj] - documentaire [adj]
documentare	[vblex] - documenter [vblex]
documentario	[n] - documentaire [adj]
documentazione	[n] - documentation [n]
documento	[n] - document [n]
documento	[n] - écrit [n]
dodicesimo	[adj] - douzième [adj.mf]
dodici	[num] - douze [num]
dogana	[n] - douane [n]
dogma	[n] - dogme [n]
dolce	[adj] - doux [adj.m.sp]
dolcemente	[adv] - doucement [adv]
dollaro	[n] - dollar [n]
dolore	[n] - douleur [n.f]
doloroso	[adj] - douloureux [adj.f]
domanda	[n] - demande [n]
domanda	[n] - question [n]
domandare	[vblex] - demander [vblex]
domani	[adv] - demain [adv]
domani	[n] - demain [adv]
domenica	[n] - dimanche [n]
domestico	[adj] - domestique [adj.mf]
domicilio	[n] - domicile [n]
dominare	[vblex] - dominer [vblex]
dominicale	[adj] - dominical [adj.f]
dominio	[n] - domination [n.f]
don	[n] - monsieur [n]
donatore	[n] - donneur [adj.f]
donazione	[n] - donation [n]
donna	[n] - femme [n]
dono	[n] - cadeau [n]
dono	[n] - monsieur [n]
doping	[n] - dopage [n]
doping	[n] - doping [n]
dopo	[adv] - après [adv]
dopo	[adv] - derrière [adv]
dopo	[pr] - après [pr]
dopo di che	[pr] - après que [cnjadv]
dopodiché	[pr] - après que [cnjadv]
dopoguerra	[n] - postguerre [n]
dorare	[vblex] - dorer [vblex]
dormire	[vblex] - assoupir [vblex]
dorsale	[adj] - dorsal [adj.f]
dose	[n] - dose [n.f.ND]
dotare	[vblex] - doter [vblex]
dote	[n] - dot [n.f]
dottorale	[adj] - doctoral [adj.f]
dottore	[n] - docteur [n]
dottrina	[n] - doctrine [n]
dove	[adv] - où [adv]
dove	[adv] - où [rel]
dovere	[n] - devoir [n]
dovere	[vbmod] - devoir [vbmod]
dozzina	[n] - douzaine [n]
drago	[n] - dragon [n]
dramma	[n.m] - tragédie [n]
dramma	[n] - drame [n]
droga	[n] - drogue [n]
dualismo	[n] - dualité [n]
dubbio	[n.m] - doute [n.m]
dubbio	[n] - doute [n.m]
duca	[n] - duc [n]
due	[num] - deux [num]
duecento	[num] - deux cents [num]
duello	[n] - deuil [n]
duetto	[n] - duo [n]
duplicare	[vblex] - doubler [vblex]
duramente	[adv] - durement [adv]
durante	[pr] - au cours de [pr]
durare	[vblex] - durer [vblex]
durata	[n.f] - durée [n]
durezza	[n] - dureté [n]
duro	[adj] - dur [adj]
e	[cnjcoo] - et [cnjcoo]
e-mail	[n] - e-mail [n]
e-mail	[n] - email [n]
ebreo	[adj] - juif [adj]
ecatombe	[n] - hécatombe [n]
eccelenza	[n] - excellence [n]
eccellente	[adj] - excellent [adj.f]
eccentricità	[n.f.sp] - excentricité [n]
eccessivamente	[adv] - excessivement [adv]
eccetera	[adv] - et caetera [cnjadv]
eccezionale	[adj] - exceptionnel [adj.f]
eccezionalmente	[adv] - exceptionnellement [adv]
eccezione	[n] - exception [n]
ecclesiastico	[adj] - ecclésiastique [adj.mf]
eco	[n] - écho [n]
economia	[n] - économie [n]
economia	[n] - économiste [n]
economicamente	[adv] - économiquement [adv]
economico	[adj] - bon marché [adj.mf]
economico	[adj] - économique [adj.mf]
economista	[n.m] - économiste [n]
economista	[n] - économiste [n]
ecuador	[n] - équateur [n]
edificio	[n] - bâtiment [n]
edificio	[n] - édification [n]
edilizia	[n] - construction [n]
edilizia	[n] - édification [n]
editoriale	[n] - éditorial [adj.f]
educazione	[n] - formation [n]
educazione	[n] - éducation [n]
effettivamente	[adv] - effectivement [adv]
effettivo	[adj] - effectif [adj]
effetto	[n] - effet [n]
efficace	[adj] - efficace [adj.mf.pl]
efficacemente	[adv] - efficacement [adv]
efficacia	[n] - efficacité [n]
efficienza	[n] - efficacité [n]
effimero	[adj] - éphémère [adj.mf]
egemonia	[n] - hégémonie [n]
egg	[n] - oeuf [n]
egiziano	[adj] - égyptien [adj]
egiziano	[n] - égyptien [adj]
egizio	[adj] - égyptien [adj]
egizio	[n] - égyptien [adj]
egli	[prn] - eux [prn.tn.p3.m.pl]
ego	[n] - ego [n]
egoista	[n] - égoïste [adj]
eiaculazione	[n] - éjaculation [n]
elaborare	[vblex] - élaborer [vblex]
elaborazione	[n] - élaboration [n]
elefante	[n] - éléphant [n]
eleggere	[vblex] - choisir [vblex]
elementare	[adj] - élémentaire [adj.mf]
elemento	[n] - élément [n]
elemosina	[n] - aumône [n]
elemòsina	[n] - aumône [n]
elencare	[vblex] - nombrer [vblex]
elenco	[n.m] - liste [n]
elephantidae	[n] - éléphant [n]
elettorale	[adj] - électoral [adj.f]
elettorato	[n] - électorat [n]
elettricità	[n.f.sp] - électricité [n]
elettrico	[adj] - électrique [adj.mf]
elettrodomestico	[n] - électroménager [n]
elettrone	[n] - électron [n]
elettronico	[adj] - électronique [adj.mf]
elevare	[vblex] - élever [vblex]
elezione	[n] - choix [n.m]
elicottero	[n] - hélicoptère [n]
eliminare	[vblex] - éliminer [vblex]
eliminazione	[n] - élimination [n]
emancipazione	[n] - émancipation [n]
emarginazione	[n] - marginalisation [n]
embargo	[n] - saisie [n.f]
embrione	[n] - embryon [n]
emendamento	[n] - amendement [n.m]
emergente	[adj] - émergent [adj.f]
emergenza	[n] - émergence [n]
emigrare	[vblex] - émigrer [vblex]
emisfero	[n] - hémisphère [n]
emissione	[n] - émission [n.f]
emorragia	[n] - hémorragie [n]
emozionalmente	[adv] - émotivement [adv]
emozione	[n] - émotion [n]
empirico	[adj] - empirique [adj.mf]
enciclopedia	[n] - encyclopédie [n]
enclave	[n] - enclave [n.f]
energia	[n] - énergie [n]
ennesimo	[adj] - énième [adj.mf.sp]
enorme	[adj] - énorme [adj]
enormemente	[adv] - énormément [adv]
ente	[n.m] - établissement [n.m]
ente	[n] - organisme [n]
entità	[n.f.sp] - établissement [n.m]
entità	[n] - nature [n]
entrambi	[adj] - les deux [det]
entrare	[vblex] - entrer [vblex]
entrata	[n] - dépôt [n]
entrata	[n] - entrée [n]
entusiasmare	[vblex] - enthousiasmer [vblex]
enza peli sulla lingua	[adv] - sans faire de mystères [adv]
epatite	[n] - hépatite [n.f.ND]
epidemia	[n] - épidémie [n]
episodio	[n] - épisode [n]
epoca	[n] - époque [n]
equatore	[n] - équateur [n]
equilibrare	[vblex] - équilibrer [vblex]
equilibrio	[n] - équilibre [n]
equivalente	[adj] - équivalent [adj.f]
equivalere	[vblex] - équivaloir [vblex]
equivocare	[vblex] - tromper [vblex]
equus caballus	[n] - jument [n]
erba	[n] - herbe [n]
erba	[n] - pelouse [n.f]
erede	[n.mf] - héritier [adj]
ereditare	[vblex] - hériter [vblex]
erezione	[n] - érection [n]
erigere	[vblex] - ériger [vblex]
ermetico	[adj] - hermétique [adj.mf]
eroe	[n] - héros [n.f]
errare	[vblex] - errer [vblex]
errore	[n] - erreur [n.f]
erudizione	[n] - érudit [adj]
eruzione	[n] - éruption [n]
esame	[n] - examen [n]
esattamente	[adv] - exactement [adv]
esattamente	[adv] - justement [adv]
esattamente	[adv] - totalement [adv]
esattezza	[n] - exactitude [n]
esatto	[adj] - exact [adj]
escludere	[vblex] - exclure [vblex]
esclusione	[n] - exclusion [n]
esclusivamente	[adv] - exclusivement [adv]
esclusivo	[adj] - exclusif [adj]
esecuzione	[n] - execution [n]
esempio	[n.m] - exemple [n]
esempio	[n] - exemple [n]
esemplare	[adj] - exemplaire [adj]
esemplare	[n] - exemplaire [adj]
esercito	[n] - armée [n.f]
esercizio	[n] - exercice [n]
esibire	[vblex] - exhiber [vblex]
esigenza	[n] - exigence [n]
esigibile	[adj] - exigible [adj]
esilio	[n] - exil [n]
esistente	[adj] - existant [adj.f]
esistenza	[n] - existence [n]
esistenziale	[adj] - existentiel [adj.f]
esistere	[vblex] - exister [vblex]
esito	[n] - succès [n.m.sp]
esodo	[n] - exode [n]
espellere	[vblex] - expulser [vblex]
espera	[n] - attente [n]
esperienza	[n] - acquis [n.m.sp]
esperimento	[n] - expérience [n.f]
esperto	[adj] - expert [adj]
esperto	[n] - expert [adj]
esplicito	[adj] - explicite [adj.mf]
esplodere	[vblex] - éclater [vblex]
esplorazione	[n] - exploration [n]
esplosione	[n] - explosion [n]
esplosivo	[adj] - explosif [adj]
esportazione	[n] - exportation [n]
esposizione	[n] - exposé [n.m]
espressamente	[adv] - expressément [adv]
espressione	[n.f] - membre [n]
espressione	[n] - expression [n]
espressionismo	[n] - expressionnisme [n]
esprimere	[vblex] - exprimer [vblex]
espropriazione	[n] - expropriation [n]
esproprio	[n] - expropriation [n]
espulsione	[n] - expulsion [n]
essenza	[n] - essence [n]
essenziale	[adj] - crucial [adj.f]
essenziale	[adj] - essentiel [adj.f]
essenzialmente	[adv] - fondamentalement [adv]
essere	[vbser] - être [n]
esso	[prn] - ce [det.dem.mf.pl]
est	[n] - ce [det.dem.mf.pl]
estate	[n] - été [n]
esteriore	[adj] - extérieur [adj.f]
esterno	[adj] - externe [adj.mf]
estetica	[n] - esthétique [n]
esteticamente	[adv] - esthétiquement [adv]
estetico	[adj] - esthétique [adj.mf]
estinzione	[n] - exctinction [n]
estremamente	[adv] - extrêmement [adv]
estremista	[n.m] - extrémiste [adj]
estremo	[n] - extrême [adj.mf]
estremo	[n] - fin [n.f]
eternally	[adv] - éternellement [adv]
eternità	[n.f.sp] - éternité [n]
eterno	[adj] - éternel [adj]
eterosessuale	[adj] - hétérosexuel [n.f]
eterosessualità	[n] - hétérosexuel [n.f]
etico	[adj] - éthique [adj.mf]
ettaro	[n.m] - hectare [n]
ettaro	[n] - hectare [n]
età	[n.f.sp] - âge [n.m]
euro	[n] - euro [n]
europeo	[adj] - européen [adj]
euskadi ta askatasuna	[n] - eta [np]
evacuamento	[n] - évacuation [n]
evacuare	[vblex] - évacuer [vblex]
evacuazione	[n] - évacuation [n]
evaporazione	[n] - évaporation [n]
evento	[n] - événement [n]
eventuale	[adj] - éventuel [adj.f]
eventualmente	[adv] - éventuellement [adv]
evidentemente	[adv] - évidemment [adv]
evidenza	[n] - évidence [n]
evitare	[vblex] - éviter [vblex]
evocare	[vblex] - évoquer [vblex]
evocazione	[n] - évocation [n]
evolutivo	[adj] - évolutif [adj]
evoluzione	[n] - évolution [n]
ex	[adj] - ex [adj]
f	[n] - f [n.m.sp]
fabbisogno	[n.m] - besoin [n.m]
fabbrica	[n] - fabrication [n]
fabbrica	[n] - fabrique [n]
fabbricante	[adj.m] - fabricant [n.f]
fabbricare	[vblex] - fabriquer [vblex]
fabbro	[n] - forgeron [n]
faccia	[n] - visage [n.m]
facciale	[adj] - facial [adj.f]
facciata	[n] - façade [n]
facile	[adj] - aisé [adj.f]
facilitare	[vblex] - faciliter [vblex]
facilità	[n.f.sp] - aisance [n]
facilmente	[adv] - aisément [adv]
facoltà	[n] - faculté [n]
falegname	[n] - menuiserie [n]
fallimento	[n.m] - banqueroute [n]
fallimento	[n] - insuccès [n.m.sp]
fallire	[vblex] - faillir [vblex]
fallo	[n] - faute [n.f]
falso	[adj] - faux [adj.f]
fame	[n.f] - faim [n.f]
fame	[n] - faim [n.f]
famiglia	[n.f] - foyer [n.m]
famiglia	[n] - famille [n]
familiare	[adj] - familial [adj.f]
famoso	[adj] - fameux [adj.f]
fanatismo	[n] - fan [n]
fanatismo	[n] - fanatisme [n]
fango	[n] - vase [n]
fantasma	[n] - fantôme [n]
fantasy	[n] - fantaisie [n]
fare	[n] - faire [vblex]
fare	[vblex] - faire [vblex]
farfalla	[n] - papillon [n.m]
farina	[n] - farine [n]
farmacia	[n] - pharmacie [n]
farmacista	[n] - pharmacien [n]
farmaco	[n] - médicament [n]
farmaco	[n] - remède [n]
faro	[n] - phare [n]
farsa	[n] - farse [n]
fascismo	[n] - fasciste [adj]
fase	[n] - phase [n]
fatale	[adj] - fatal [adj.f]
fattibile	[adj] - faisable [adj]
fatto	[n] - fait [n]
fattura	[n] - facture [n]
fauna	[n] - faune [n]
favore	[n] - faveur [n.f]
favorevolmente	[adv] - favorablement [adv]
favorire	[vblex] - avantager [vblex]
fazione	[n] - faction [n]
faziosità	[n.f.sp] - partialité [n]
fazzoletto	[n] - mouchoir [n]
febbraio	[n.m.pl] - février [n]
febbraio	[n.m.sp] - février [n]
febbraio	[n] - février [n]
febbre	[n] - fièvre [n]
fede	[n] - foi [n]
fedele	[adj] - fidèle [adj]
fedele	[n] - fidèle [adj]
fedelmente	[adv] - fidèlement [adv]
federale	[adj] - fédéral [adj.f]
federazione	[n.f] - federation [n]
fegato	[n] - foie [n]
felicemente	[adv] - joyeusement [adv]
felicità	[n.f.sp] - bonheur [n.m]
felis silvestris catus	[n] - chat [n.f]
femmina	[n] - femelle [n]
femminile	[adj] - féminin [adj]
femminista	[n] - féministe [adj]
fenomenale	[adj] - phénoménal [adj.f]
fenomeno	[n] - apparence [n]
fenomeno	[n] - phénomène [n]
ferita	[n] - blessure [n]
ferita	[n] - blessé [n]
ferro	[n] - fer [n]
ferro da stiro	[n] - fer à repasser [n.m]
festa	[n] - fête [n]
festival	[n] - festival [n]
feto	[n] - foetus [n.m.sp]
fiamma	[n] - flamme [n]
fibra	[n] - fibre [n]
fidarsi	[vblex] - confier [vblex]
fiducia	[n] - confiance [n]
figlia	[n] - fille [n]
figlio	[n] - fille [n]
figlio	[n] - fils [n.f]
figurare	[vblex] - figurer [vblex]
file	[n.m.sp] - fichier [n]
filiale	[adj.mf] - filial [adj.f]
film	[n] - film [n.m]
film	[n] - film [n]
filosofia	[n] - philosophie [n]
filosofico	[adj] - philosophique [adj.mf]
filtrare	[vblex] - filtrer [vblex]
filtrazione	[n] - filtration [n]
filtro	[n] - filtre [n]
finale	[adj] - final [adj.f]
finale	[n] - final [adj.f]
finanziamento	[n.m] - financement [n.m]
finanziamento	[n] - financement [n.m]
finanziare	[vblex] - financer [vblex]
finanziario	[adj] - financier [adj]
finché	[cnjsub] - jusqu'à ce que [cnjadv]
fine	[n.mf] - affection [n.f]
fine	[n.mf] - fin [n.f]
finestra	[n] - fenêtre [n]
finestrino	[n.m] - guichet [n.m]
fingere	[vblex] - feindre [vblex]
finire	[vblex] - achever [vblex]
finlandese	[n] - finlandais [adj.f]
fino	[adj] - fin [adj]
fino	[adv] - jusqu'à [pr]
fino	[pr] - jusqu'à [pr]
fino a un certo punto	[adv] - dans une certaine mesure [adv]
fino ad allora	[adv] - jusqu'alors [adv]
finora	[adv] - jusqu'à aujourd'hui [cnjadv]
finora	[adv] - pour l'instant [adv]
fiore	[n.m] - fleur [n]
firewall	[n] - coupe-feu [n.m.sp]
firma	[n] - firme [n]
firmamento	[n] - firmament [n]
firmare	[vblex] - signer [vblex]
fisarmonica	[n] - accordéon [n]
fisarmonicista	[n.GD.pl] - accordéoniste [n]
fisarmonicista	[n.mf.sg] - accordéoniste [n]
fiscale	[adj] - fiscal [adj.f]
fischio	[n] - sifflement [n]
fisicamente	[adv] - physiquement [adv]
fisico	[adj] - physique [adj.mf]
fisico	[n] - physique [adj.mf]
fisioterapia	[n] - physiothérapie [n]
fiume	[n] - rivière [n.f]
flessibile	[adj] - souple [adj]
flora	[n] - flore [n]
fluidità	[n.f.sp] - fluidité [n]
flusso	[n] - flux [n.m.sp]
fluttuazione	[n] - fluctuation [n]
fobia	[n] - phobie [n]
foglia	[n] - feuille [n.f]
foglio	[n.m] - feuille [n.f]
foglio	[n] - feuille [n.f]
folclore	[n] - folklore [n]
fondamentale	[adj] - fondamental [adj.f]
fondamentale	[adj] - primordial [adj.f]
fondamentalismo	[n] - fondamentaliste [n]
fondamentalmente	[adv] - fondamentalement [adv]
fondare	[vblex] - fonder [vblex]
fondatore	[n] - fondateur [n]
fondazione	[n] - fondation [n]
fondazioni	[n] - fondement [n]
fondere	[vblex] - fondre [vblex]
fondo	[n] - fond [n]
fontaine	[n] - source [n]
fonte	[n] - source [n]
forca	[n] - force [n]
forchetta	[n] - fourchette [n.f]
foresta	[n.f] - bois [n.m.sp]
foresta	[n] - bois [n.m.sp]
forestale	[adj] - forestier [adj.f]
formaggio	[n] - fromage [n]
formale	[adj] - formel [adj.f]
formalmente	[adv] - formellement [adv]
formare	[vblex] - former [vblex]
format	[n] - format [n]
formica	[n] - fourmi [n]
formicidae	[n] - fourmi [n]
formula	[n] - formule [n]
fornire	[vblex] - approvisionner [vblex]
forno	[n] - four [n]
foro	[n] - forum [n]
forse	[adv] - peut-être [adv]
fortemente	[adv] - fortement [adv]
fortezza	[n] - forteresse [n]
fortuna	[n] - fortune [n]
fortunatamente	[adv] - heureusement [adv]
forza	[n] - force [n]
forza peso	[n] - peser [vblex]
forza peso	[n] - poids [n.m.sp]
forzare	[vblex] - forcer [vblex]
forzosamente	[adv] - inévitablement [adv]
fossile	[n] - fossile [n]
fosso	[n.m] - fossé [n.m]
foto	[n] - photo [n]
fotocopiare	[vblex] - photocopier [vblex]
fotocopiatrice	[n] - photocopie [n]
fotografare	[vblex] - photographier [vblex]
fotografia	[n] - photo [n]
fotografia	[n] - photographe [n.mf]
fotografia	[n] - photographie [n]
fotografico	[adj] - photographique [adj.mf]
fotogramma	[n] - photogramme [n]
fotone	[n] - photon [n.mf]
fra	[pr] - entre [pr]
fra la spada e la parete	[adv] - dos au mur [adv]
fragaria	[n] - fraise [n]
fragile	[adj] - fragile [adj]
fragilità	[n.f.sp] - fragilité [n]
fragola	[n] - fraise [n]
frammento	[n] - fragment [n]
francamente	[adv] - carrément [adv]
francese	[n] - français [adj.f]
franchising	[n] - franchise [n]
franchismo	[n] - franquisme [n]
franchista	[n] - franquiste [adj]
francisco mancebo	[n] - jeune homme [n]
franco	[adj] - franc [adj]
frase	[n] - phrase [n]
frate	[n] - moine [n]
fratellanza	[n] - fraternité [n]
fratello	[n] - frère [n.m]
frattura	[n] - fracture [n]
frazione	[n] - fraction [n]
freccia	[n] - flèche [n]
freddamente	[adv] - froidement [adv]
freddo	[n] - froid [adj]
frenare	[vblex] - freiner [vblex]
frenetico	[adj] - frénétique [adj.mf]
freno	[n] - frein [n]
frequente	[adj] - fréquent [adj.f]
frequentemente	[adv] - fréquemment [adv]
frequenza	[n] - fréquence [n]
freschezza	[n.f] - fraîcheur [n.f]
fresco	[n] - frais [adj.f]
frigorifero	[n.m] - réfrigérateur [n.m]
frigorifero	[n] - frigorifique [adj.mf]
frigorifero	[n] - réfrigérateur [n.m]
frode	[n.f] - fraude [n]
frode	[n] - fraude [n]
frontalmente	[adv] - frontalement [adv]
fronte	[n] - front [n.m]
frontiera	[n] - frontière [n]
frumento	[n] - blé [n]
frustrare	[vblex] - frapper [vblex]
frustrare	[vblex] - frustrer [vblex]
frutta	[n] - fruit [n.m]
frutto	[n] - fruit [n.m]
frutto	[n] - fruit [n]
frutto-di-mare	[n] - fruits de mer [n.m.pl]
fucile	[n] - fusil [n]
fuga	[n] - fuite [n]
fuggire	[vblex] - fuir [vblex]
fulgore	[n] - lueur [n.f]
fulmine	[n] - rai [n]
fumare	[n] - fumer [vblex]
fumare	[vblex] - fumer [vblex]
fumo	[n] - fumée [n.f]
funerale	[n] - enterrement [n]
funerale	[n] - inhumation [n.f]
funerale	[n] - obsèques [n.f.pl]
funerale	[n] - sépulture [n]
funzionale	[adj] - fonctionnel [adj.f]
funzionario	[n] - fonctionnaire [n.mf]
funzione	[n] - fonction [n]
fuoco	[n] - feu [n]
fuoco	[n] - foyer [n]
fuoco d'artificio	[n] - pyrotechnie [n]
fuori	[adv] - dehors [adv]
fuori	[pr] - en dehors de [pr]
fuori di	[pr] - en dehors de [pr]
furia	[n] - furie [n]
furto	[n] - larcin [n]
furto	[n] - vol [n]
furto	[n] - voleur [n]
futuro	[n] - futur [adj]
g	[n] - g [n.m]
gabinetto	[n] - cabinet [n]
galassia	[n] - galaxie [n]
galleggiante	[adj] - flottant [adj.f]
gallego	[n] - galicien [adj]
galleria	[n.f] - tunnel [n]
galleria	[n] - galerie [n]
gallico	[n] - français [adj.f]
gallina	[n] - poule [n]
gallo	[n] - coq [n]
gallus gallus	[n] - poule [n]
gallus gallus	[n] - poulet [n]
gamba	[n] - crevette [n]
gamba	[n] - jambe [n]
gambero	[n] - crevette [n]
gamma	[n.f] - éventail [n]
gamma	[n] - gamme [n]
gancio	[n] - crochet [n]
garage	[n] - garage [n]
garantire	[vblex] - garantir [vblex]
garanzia	[n] - aval [n]
garanzia	[n] - garantie [n]
gariga	[n] - rond [n]
gas	[n] - gaz [n.m.sp]
gasolio	[n] - gasoil [n]
gastronomia	[n] - gastronomie [n]
gatto	[n] - chat [n.f]
gemma	[n] - nègre [adj.mf]
gene	[n] - gène [n]
generale	[adj] - général [adj.f]
generale	[n] - général [adj.f]
generalmente	[adv] - généralement [adv]
generare	[vblex] - générer [vblex]
generazionale	[adj] - générationnel [adj.f]
generazione	[n] - generation [n]
genere	[n] - genre [n]
geniale	[adj] - génial [adj.f]
gennaio	[n.m.pl] - janvier [n]
gennaio	[n.m.sp] - janvier [n]
gennaio	[n] - janvier [n]
genocidio	[n] - génocide [n]
gente	[n] - gens [n.m.pl]
gentilmente	[adv] - attentivement [adv]
geografia	[n] - géographie [n]
geografico	[adj] - géographique [adj.mf]
geologico	[adj] - géologique [adj.mf]
geometrico	[adj] - géométrique [adj.mf]
gerarchia	[n] - hiérarchie [n]
germe	[n] - germe [n]
gestazione	[n] - gestation [n]
gestione	[n] - gestion [n]
gestual	[adj] - gestuel [adj.f]
gestuale	[adj] - gestuel [adj.f]
gettare	[vblex] - jeter [vblex]
ghiacciaio	[n] - glacier [n]
ghiaccio	[n] - gel [n]
giacca	[n] - jaquette [n]
giacché	[cnjadv] - du fait que [cnjadv]
giamaica	[n] - jamaïcain [adj]
giapponese	[n] - japonais [adj.f]
giardinaggio	[n] - jardinage [n.m]
giardiniere	[n] - jardinier [n]
giardino	[n] - jardin [n]
giardino zoologico	[n] - zoo [n]
giardino zoologico	[n] - zoologique [n]
gigante	[n] - géant [adj.f]
gigantesco	[adj] - gigantesque [adj.mf]
ginecologia	[n] - gynécologue [n.mf]
ginecologo	[n] - gynécologue [n.mf]
ginevra	[n] - gin [n.m]
ginnastica	[n] - gymnastique [n]
ginocchio	[n] - genou [n.m]
giocare	[vblex] - jouer [vblex]
giocatore	[n] - joueur [adj]
giocattolo	[n] - jouet [n.m]
gioco	[n] - jeu [n]
gioielleria	[n] - bijouterie [n]
gioiello	[n] - allégresse [n]
giornale	[n] - presse [n]
giornale	[n] - périodique [adj.mf]
giornalismo	[n] - journalisme [n]
giornalista	[n.f.pl] - journaliste [n]
giornalista	[n.GD] - journaliste [n]
giornalista	[n.m.pl] - journaliste [n]
giornalista	[n.mf.sg] - journaliste [n]
giornalista	[n] - journaliste [n]
giornalistico	[adj] - journalistique [adj.mf]
giornalmente	[adv] - quotidiennement [adv]
giorno	[n] - jour [n]
giovane	[n] - jeune [adj]
giovanile	[adj] - juvénile [adj]
giovedì	[n] - jeudi [n.m.ND]
giovinezza	[n] - jeunesse [n]
girare	[vblex] - tourner [vblex]
giudiziariamente	[adv] - judiciairement [adv]
giudiziario	[adj] - judiciaire [adj]
giugno	[n.m.pl] - juin [n]
giugno	[n.m.sp] - juin [n]
giungere	[vblex] - arriver [vblex]
giungla	[n] - jungle [n]
giuntura	[n] - articulation [n]
giurare	[vblex] - jurer [vblex]
giuridicamente	[adv] - juridiquement [adv]
giuridico	[adj] - juridique [adj.mf]
giurisdizione	[n] - juridiction [n]
giurisprudenza	[n] - jurisprudence [n]
giustamente	[adv] - justement [adv]
giustificazione	[n] - justification [n]
giustizia	[n] - injustice [n]
giustizia	[n] - justice [n]
giusto	[adv] - juste [adj.mf]
già	[adv] - déjà [adv]
giù	[adv] - en bas [adv]
glaciale	[adj] - glacier [n]
gli	[prn.pro.p3.mf.sp] - leur [prn.enc.p3.mf.pl]
globale	[adj] - globale [adj]
globalizzazione	[n] - globalisation [n]
gloria	[n] - gloire [n]
glutine	[n] - gluten [n]
goccia	[n] - goutte [n]
godimento	[n] - joie [n.f]
gol	[n] - but [n]
gola	[n] - gorge [n]
golf	[n] - golf [n]
golfo	[n] - golfe [n]
gomito	[n] - coude [n]
gomma	[n] - gomme [n]
gomma da masticare	[n] - chewing-gum [n]
gomma-da-masticare	[n] - chewing-gum [n]
gonna	[n] - jupe [n]
gorilla gorilla	[n] - gorille [n]
governare	[vblex] - gouverner [vblex]
governativo	[adj] - gouvernemental [adj.f]
governatore	[n] - gouverneur [n]
governo	[n] - gouv [n.m.sp]
governo	[n] - gouvernant [n]
grado	[n] - degré [n]
grado	[n] - rang [n]
graduale	[adj] - graduel [adj.f]
grafico	[adj] - graphique [adj.mf]
grafico	[n] - graphique [adj.mf]
grammo	[n] - gramme [n]
granada	[n] - grenade [n]
granchio	[n] - crabe [n]
grande	[adj] - grand [adj.f]
grande	[adj] - grand [adj.GD]
grandine	[n.f] - grêle [n.f]
grandine	[n] - grêle [n.f]
granito	[n] - granite [n]
grasso	[adj] - gras [adj.f]
grasso	[n] - gras [n.m.sp]
gratamente	[adv] - agréablement [adv]
gratificare	[vblex] - gratifier [vblex]
gratis	[adv] - gratis [adv]
grattacielo	[n] - gratte-ciel [n]
grattare	[vblex] - gratter [vblex]
gratuitamente	[adv] - gratuitement [adv]
gratuito	[adj] - gratuit [adj]
gravemente	[adv] - gravement [adv]
gravidanza	[n] - gestation [n]
gravità	[n.f.sp] - gravité [n]
gravità	[n] - gravité [n]
grazia	[n] - grâce [n.f]
greco	[adj] - grec [adj]
gridare	[vblex] - crier [vblex]
grifone	[n] - robinet [n]
grigio	[adj] - gris [adj.m.sp]
grossista	[n.m] - grossiste [n]
grosso	[adj] - gros [adj.f]
grossolaneria	[n] - grossièreté [n]
gru	[n] - grue [n]
gruppo	[n] - groupe [n]
gruppo	[n] - groupement [n.m]
guadagnare	[vblex] - gagner [vblex]
guanto	[n] - gant [n]
guardare	[vblex] - dévisager [vblex]
guardia	[n] - garde [n]
guardia del corpo	[n] - garde du corps [n.mf.ND]
guardone	[n] - badaud [adj]
guerra	[n] - guerre [n]
guerra di trincea	[n] - tranchée [n]
guerriero	[adj] - guerrier [adj]
guerriero	[n.f] - guerrier [adj]
guerriero	[n.GD] - guerrier [adj]
guerriero	[n.m] - guerrier [adj]
guerriglia	[n] - de guérilleros [adj.mf.sp]
guerriglia	[n] - guérilla [n]
guerrigliero	[n] - de guérilleros [adj.mf.sp]
guidare	[vblex] - conduire [vblex]
guidare	[vblex] - guider [vblex]
guinzaglio	[n] - courroie [n]
guscio	[n.m] - coquille [n]
gusto	[n] - goût [n]
h	[n] - h [n.m]
ha avanti	[adv] - avant [adv]
habitat	[n] - habitat [n]
handicap	[n] - handicap [n.m]
hashish	[n] - haschisch [n]
helianthus annuus	[n] - tournesol [n]
herencia	[n] - héritage [n.m]
hidalgo	[n] - gentilhomme [n]
hobby	[n.m.pl] - supporters [n.m.pl]
hobby	[n.m.sp] - supporters [n.m.pl]
hockey	[n] - hockey [n]
hotel	[n] - hôtel [n]
html	[np] - html [np]
humanità	[n.f.sp] - humanité [n]
iberico	[adj] - ibérique [adj.mf]
iceberg	[n] - iceberg [n]
icona	[n] - icône [n.f]
idea	[n] - idée [n]
ideale	[adj] - idéal [adj.f]
ideare	[vblex] - idéer [vblex]
identico	[adj] - identique [adj.mf]
identificare	[vblex] - identifier [vblex]
identificazione	[n] - identification [n]
identità	[n.f.sp] - identité [n]
ideologia	[n] - idéologie [n]
ideologicamente	[adv] - idéologiquement [adv]
idioma	[n] - idiome [n]
idiosincrasia	[n] - idiosyncrasie [n]
idiota	[n] - idiot [adj.f]
idolo	[n] - idole [n.f]
idraulico	[n] - plombier [n]
idrocarburi	[n] - hydrocarbure [n]
idrocarburo	[n] - hydrocarbure [n]
ieri	[adv] - hier [adv]
igiene	[n] - hygiène [n]
ignoranza	[n] - ignorance [n]
ignorare	[vblex] - ignorer [vblex]
il	[det.def.mf] - le [det.def.mf.pl]
il	[det.def] - le [det.def.mf.pl]
il che	[rel] - le [detnt]
il cui	[rel] - dont [rel.mf.sp]
il loro	[det.pos.f] - à il [adj.pos]
il loro	[det.pos.m] - à il [adj.pos]
il mio	[det.pos.f] - à moi [adj.pos.mf.sp]
il mio	[det.pos.GD] - à moi [adj.pos.mf.sp]
il mio	[det.pos.m] - à moi [adj.pos.mf.sp]
il nostro	[det.pos] - à nous [adj.pos.mf.sp]
il quale	[rel] - celui que [rel.nt]
il quale	[rel] - celui que [rel]
il suo	[det.pos.f] - à il [adj.pos]
il suo	[det.pos.GD] - à il [adj.pos]
il suo	[det.pos.m] - à il [adj.pos]
il tuo	[det.pos.f] - à toi [adj.pos.mf.sp]
il tuo	[det.pos.GD] - à toi [adj.pos.mf.sp]
il tuo	[det.pos.m] - à toi [adj.pos.mf.sp]
il vostro	[det.pos] - à vous [adj.pos.mf.sp]
ilarità	[n.f.sp] - hilarité [n]
illegale	[adj] - illégal [adj.f]
illegalmente	[adv] - illégalement [adv]
illegittimo	[adj] - illégitime [adj.mf]
illuminazione	[n] - illumination [n]
illuminismo	[n] - illustration [n]
illusione	[n] - illusion [n]
illustrare	[vblex] - illustrer [vblex]
imbarcare	[vblex] - embarquer [vblex]
imbarcazione	[n.f] - yacht [n]
imbecille	[adj] - imbécile [adj]
imitare	[vblex] - imiter [vblex]
immagazzinamento	[n] - emmagasinage [n]
immaginazione	[n] - imagination [n]
immagine	[n.mf] - image [n]
immagine	[n] - image [n]
immediatamente	[adv] - aussitôt [adv]
immediatamente	[adv] - immédiatement [adv]
immigrante	[n] - immigrant [adj.f]
immigrato	[n.m] - immigrant [adj.f]
imminente	[adj] - imminent [adj.f]
immobile	[adj] - immobile [adj]
immondizia	[n] - ordures [n.f.pl]
immunità	[n.f.sp] - immunité [n]
impalcatura	[n] - échafaudage [n]
imparare	[vblex] - apprendre [vblex]
imparziale	[adj] - impartial [adj.f]
impatto	[n] - impact [n]
imperativo	[n] - impératif [adj]
imperatore	[n] - empereur [n]
imperialismo	[n] - impérialisme [n]
impero	[n] - empire [n]
impianto	[n.m] - installation [n]
impianto	[n.m] - plantation [n]
impiegato	[n] - employé [n]
impiego	[n] - emploi [n]
impiego lavorativo	[n] - emploi [n]
implicare	[vblex] - concerner [vblex]
implicazione	[n] - implication [n]
impopolare	[adj] - impopulaire [adj]
importante	[adj] - important [adj.f]
importare	[vblex] - importer [vblex]
importazione	[n] - importation [n]
imposizione	[n] - dépôt [n.m]
imposta	[n] - impôt [n]
impotenza	[n] - impuissance [n]
impoverire	[vblex] - appauvrir [vblex]
impregnare	[vblex] - imprégner [vblex]
imprenditore	[n] - chef d'entreprise [n.m]
imprenditoriale	[adj] - de commerce et de gestion [adj.mf.sp]
impresa	[n] - entreprise [n]
impressionabile	[adj] - émotionnel [adj.f]
impressione	[n] - impression [n]
imprevedibile	[adj] - imprévisible [adj]
imprevisto	[n] - imprévu [n]
improvvisazione	[n] - improvisation [n]
impulsare	[vblex] - stimuler [vblex]
impulso	[n] - impulsion [n.f]
impunemente	[adv] - impunément [adv]
impunità	[n.f.sp] - impunité [n]
imputabile	[adj] - imputable [adj]
imputare	[vblex] - imputer [vblex]
in	[pr] - chez [pr]
in altri tempi	[adv] - au temps jadis [adv]
in altro modo	[adv] - autrement [adv]
in assoluto	[adv] - absolument pas [adv]
in cambio	[adv] - en revanche [adv]
in certa misura	[adv] - dans une certaine mesure [adv]
in difficoltà	[adv] - dans des difficultés [adv]
in effetti	[adv] - en fait [adv]
in fila indiana	[adv] - en file indienne [adv]
in filiera	[adv] - en rangée [adv]
in generale	[adv] - régulièrement [adv]
in interdizione	[adv] - en défense [adv]
in maniera dovuta	[adv] - dûment [adv]
in modo che	[cnjadv] - de sorte que [cnjadv]
in più	[adv] - de plus [adv]
in ritardo	[adv] - tard [adv]
in secondo luogo	[adv] - deuxièmement [adv]
in segreto	[adv] - en secret [adv]
in silenzio	[adv] - à la silencieuse [adv]
in tutti i modi	[adv] - dans tous les cas [adv]
inaccettabile	[adj] - inacceptable [adj]
inalazione	[n] - inhalation [n]
inaugurale	[adj] - inaugural [adj.f]
inaugurare	[vblex] - inaugurer [vblex]
incanto	[n] - hampe [n]
incarico	[n] - commission [n.f]
incendiare	[vblex] - incendier [vblex]
incendio	[n] - incendie [n]
incenerimento	[n] - incinération [n]
incentivare	[vblex] - encourager [vblex]
incentivazione	[n.f] - encouragement [n]
incentivo	[n] - stimulant [n]
incessante	[adj] - incessant [adj.f]
inchiesta	[n] - enquête [n]
incidente	[adj] - incident [n]
incidente	[n] - accident [n]
incidente	[n] - incident [n]
incidenza	[n] - incidence [n]
incisivo	[adj] - incisif [adj]
incitamento	[n.m] - incitation [n]
incitare	[vblex] - inciter [vblex]
inclinare	[vblex] - incliner [vblex]
inclinazione	[n] - inclination [n]
inclusivamente	[adv] - inclus [adv]
incollare	[vblex] - coller [vblex]
incomparabile	[adj] - incomparable [adj]
incompatibile	[adj] - incompatible [adj]
incompleto	[adj] - incomplet [adj]
incondizionale	[adj] - inconditionnel [adj.f]
incondizionalmente	[adv] - inconditionnellement [adv]
incondizionato	[adj] - inconditionnel [adj.f]
incontrare	[vblex] - rencontrer [vblex]
incorporare	[vblex] - incorporer [vblex]
incorporazione	[n] - incorporation [n]
incredibilmente	[adv] - incroyablement [adv]
incrementare	[vblex] - accroître [vblex]
incremento	[n] - accroissement [n]
incremento	[n] - augmentation [n.f]
incriminare	[vblex] - incriminer [vblex]
incrociatore	[n] - croisière [n.f]
incubo	[n] - cauchemar [n.m]
incudine	[n] - enclume [n.f]
indagine	[n] - recherche [n]
indebitamente	[adv] - injustement [adv]
indebitamento	[n] - endettement [n]
indebolire	[vblex] - affaiblir [vblex]
indesiderabile	[adj] - indésirable [adj]
indiano	[n] - indien [adj]
indicare	[vblex] - flécher [vblex]
indicare	[vblex] - indiquer [vblex]
indicatore	[n] - indicateur [n]
indice	[n] - index [n.m.sp]
indio	[n] - indien [adj]
indipendente	[adj] - indépendant [adj.f]
indipendentemente	[adv] - indépendamment [adv]
indipendenza	[n] - indépendance [n]
indirettamente	[adv] - indirectement [adv]
indirizzo	[n.m] - orientation [n]
indirizzo	[n] - adresse [n]
indispensabile	[adj] - indispensable [adj]
indistintamente	[adv] - indistinctement [adv]
indivia	[n] - envie [n]
individuale	[adj] - individuel [adj.f]
individualmente	[adv] - individuellement [adv]
individuo	[n] - individu [n.m]
indonesiano	[adj] - indonésien [adj]
indovinello	[n] - mystère [n]
indubitabile	[adj] - indubitable [adj]
indulto	[n] - grâce [n.f]
industria	[n] - industrie [n]
industriale	[adj] - industriel [adj.f]
industrializzazione	[n] - industrialisation [n]
inefficace	[adj] - inefficace [adj]
inerzia	[n] - inertie [n]
inevitabile	[adj] - inévitable [adj]
infante	[n] - infant [n]
infantile	[adj] - enfantin [adj.f]
infanzia	[n] - enfance [n]
infarto	[n] - infarctus [n.m.sp]
infedele	[adj] - infidèle [adj]
inferiore	[adj] - inférieur [adj.f]
infermiere	[n] - infirmier [n]
infernale	[adj] - infernal [adj.f]
inferno	[n] - enfer [n]
infezione	[n] - infection [n]
infiltrazione	[n] - infiltration [n]
infine	[adv] - en somme [adv]
infine	[adv] - enfin [adv]
infine	[adv] - finalement [adv]
infinitamente	[adv] - infiniment [adv]
infinito	[n] - infini [adj]
inflazione	[n] - inflation [n]
influenza	[n] - grippe [n]
informale	[adj] - informel [adj.f]
informare	[vblex] - informer [vblex]
informazione	[n.mf] - renseignement [n.m]
infrastruttura	[n] - infrastructure [n]
infrastrutture	[n] - infrastructure [n]
ingannare	[vblex] - duper [vblex]
ingegnere	[n] - ingénieur [n.mf]
ingegneria	[n] - ingénierie [n]
ingenio	[n] - ingéniosité [n.f]
ingenuo	[adj] - dupe [adj.mf]
ingiustamente	[adv] - injustement [adv]
inglese	[n] - anglais [adj.f]
iniezione	[n] - injection [n]
ininterrottamente	[adv] - de façon ininterrompue [adv]
iniziale	[adj] - initial [adj.f]
inizialmente	[adv] - initialement [adv]
iniziare	[vblex] - commencer [vblex]
iniziare	[vblex] - entamer [vblex]
innamorato	[n] - amoureux [adj.f]
innanzi a	[pr] - devant [pr]
inno	[n] - hymne [n]
innovazione	[n] - innovation [n]
innumerevole	[adj] - innombrable [adj]
inoltre	[adv] - de plus [adv]
inondare	[vblex] - inonder [vblex]
inondazione	[n] - crue [n]
inondazione	[n] - inondation [n]
inossidabile	[adj] - inoxydable [adj]
input	[n] - entrée [n]
inquietante	[adj] - inquiétant [adj.f]
inquinamento	[n] - contamination [n]
inscrivere	[vblex] - inscrire [vblex]
insecta	[n] - insecte [n]
insediamento	[n] - établissement [n]
insegnamento	[n.m] - enseignement [n.m]
insegnamento	[n] - enseignement [n.m]
insegnante	[n] - maître [n]
insegnare	[vblex] - enseigner [vblex]
inseparabile	[adj] - inséparable [adj]
inserimento	[n.m] - insertion [n]
inserimento	[n] - intégration [n.m]
insetti	[n] - insecte [n]
insieme	[adv] - conjointement [adv]
insieme	[adv] - ensemble [adv]
insieme	[n] - conjoint [adj]
insieme aperto	[n] - voisinage [n.m]
insignificante	[adj] - insignifiant [adj.f]
insolubile	[adj] - insoluble [adj]
insolvente	[adj] - insolvable [adj]
insonnia	[n.f] - insomnie [n.f]
insostenibile	[adj] - intenable [adj]
inspirare	[vblex] - inspirer [vblex]
instabile	[adj] - instable [adj]
installare	[vblex] - installer [vblex]
installazione	[n] - installation [n]
instaurare	[vblex] - instaurer [vblex]
insufficientemente	[adv] - insuffisamment [adv]
insulina	[n] - insuline [n]
insultare	[vblex] - insulter [vblex]
insulto	[n] - insulte [n.f]
insurrezione	[n] - insurrection [n]
integrale	[adj] - intégral [adj.f]
integrale	[n] - intégral [adj.f]
integrale	[n] - intégration [n.m]
integralmente	[adv] - intégralement [adv]
integrare	[vblex] - intégrer [vblex]
intellettuale	[adj] - intellectuel [adj.f]
intelligente	[adj] - intelligent [adj.f]
intelligenza	[n] - intelligence [n]
intendimento	[n] - entendement [n]
intensamente	[adv] - avec toutes les forces [adv]
intensificare	[vblex] - approfondir [vblex]
intensificare	[vblex] - intensifier [vblex]
intensità	[n.f.sp] - intensité [n]
intenso	[adj] - intense [adj.mf]
intento	[n] - tentative [n.f]
intenzione	[n] - intention [n]
interamente	[adv] - entier [adj]
interamente	[adv] - totalement [adv]
interannuale	[adj] - sur douze mois [adj.mf.sp]
interazione	[n] - interaction [n]
interessante	[adj] - intéressant [adj.f]
interesse	[n] - intérêt [n]
interferenza	[n] - interférence [n]
interiore	[n] - intérieur [adj.f]
interiorizzare	[vblex] - intérioriser [vblex]
interiormente	[adv] - intérieurement [adv]
interlocutore	[n] - interlocuteur [n]
intermediario	[n] - intermédiaire [adj.mf]
intermedio	[adj] - intermède [n]
intermedio	[n] - intermède [n]
internazionale	[adj] - international [adj.f]
internazionalmente	[adv] - internationalement [adv]
internet	[n] - internet [n.m]
interno	[adj.m] - intérieur [adj.f]
interprete	[n] - interprète [n]
interprete	[n] - interprétation [n]
interprofessionale	[adj] - interprofessionnel [adj.f]
interrogare	[vblex] - interroger [vblex]
interrogare	[vblex] - interviewer [vblex]
interrompere	[vblex] - interrompre [vblex]
interrupt	[n] - interruption [n]
intersezione	[n] - intersection [n]
intervento	[n.m] - intervention [n]
intervista	[n] - entretien [n.m]
intestatario	[n.m] - titulaire [adj]
intestino	[n] - intestin [n]
intimo	[adj] - intime [adj.mf]
intorno	[adv] - autour [adv]
intossicazione	[n] - intoxication [n]
introdurre	[vblex] - introduire [vblex]
introduzione	[n] - introduction [n]
introspezione	[n] - introspection [n]
intuizione	[n] - intuition [n]
inumano	[adj] - inhumain [adj]
inutile	[adj] - inutile [adj]
invalidare	[vblex] - invalider [vblex]
invasione	[n] - invasion [n]
invecchiare	[vblex] - vieillir [vblex]
inventare	[vblex] - inventer [vblex]
inventario	[n] - recensement [n]
inverno	[n] - hiver [n]
inverso	[adj] - inverse [adj.mf]
invertire	[vblex] - inverser [vblex]
investigare	[vblex] - enquêter [vblex]
investigatore	[n] - détective [n]
investimento	[n.m] - investissement [n.m]
investimento	[n] - investissement [n.m]
investire	[vblex] - inverser [vblex]
invidia	[n] - envie [n]
inviolabile	[adj] - inviolable [adj]
invisibile	[adj] - invisible [adj]
invitare	[vblex] - convier [vblex]
invito	[n.m] - convocation [n]
invito	[n] - invitation [n]
invocare	[vblex] - invoquer [vblex]
involontariamente	[adv] - involontairement [adv]
io	[prn.tn] - je [prn]
ipoteca	[n] - hypothèque [n]
ipotermia	[n] - hypothermie [n]
ira	[n] - colère [n]
iran	[n] - iranien [adj.f]
iraq	[n] - irakien [n.f]
iride	[n] - iris [n]
irlandese	[adj] - irlandais [adj.f]
irlandese	[n] - irlandais [adj.f]
ironia	[n] - ironie [n]
irreale	[adj] - irréel [adj.f]
irregolare	[adj] - irrégulier [adj.f]
irreparabile	[adj] - irréparable [adj]
irresponsabile	[adj] - irresponsable [adj]
irresponsabilmente	[adv] - irresponsablement [adv]
irreversibile	[adj] - irréversible [adj]
irrifiutabile	[adj] - irréfutable [adj]
irrigazione	[n.f] - arrosage [n]
irrigazione	[n] - arrosage [n]
irrimediabile	[adj] - irrémédiable [adj]
irrimediabilmente	[adv] - irrémédiablement [adv]
irritare	[vblex] - irriter [vblex]
irritazione	[n] - irritation [n]
irruzione	[n] - irruption [n]
iscrizione	[n] - inscription [n]
islam	[n] - islam [n]
islamico	[adj] - islamique [adj.mf]
islamismo	[n] - islamiste [n]
isola	[n] - île [n]
isolamento	[n.m] - préservation [n]
isolamento	[n] - isolement [n]
ispezione	[n] - inspection [n]
ispirazione	[n] - inspiration [n]
israeliano	[adj] - israélien [adj.f]
istantaneo	[adj] - instantané [adj]
istante	[n] - instant [n]
istanza	[n] - instance [n]
istigazione	[n] - instigation [n]
istinto	[n] - instinct [n]
istituto	[n.m] - institution [n]
istituto	[n] - institut [n]
istituzionale	[adj] - institutionnel [adj.f]
istituzione	[n] - institution [n]
istruzione	[n] - instruction [n]
italiano	[n] - italien [adj]
jersey	[n] - jersey [n]
jinn	[n] - caractère [n]
josé luis rodríguez zapatero	[n] - cordonnier [n]
joule	[n.m.pl] - juillet [n]
juglans regia	[n] - noyer [n]
juta	[n] - jute [n]
kilo	[n] - kilo [n]
kindergarten	[n] - garderie [n]
l	[n] - l [n.m]
l'altro ieri	[adv] - avant-hier [adv]
la fiamma del peccato	[n] - perdition [n]
la maggior parte delle volte	[adv] - la plupart du temps [adv]
la notte scorsa	[adv] - hier soir [adv]
labbro	[n.f] - lèvre [n.f]
labbro	[n] - lèvre [n.f]
labirinto	[n] - labyrinthe [n]
laboratorio	[n] - laboratoire [n]
labrador	[n] - laboureur [n]
lacrima	[n] - larme [n]
lacuna	[n] - creux [n.m.sp]
ladro	[n] - voleur [n]
lago	[n] - lac [n]
laguna	[n] - lagune [n]
laicità	[n] - laïcisme [n]
laico	[adj] - laïque [adj.mf]
lamentabilmente	[adv] - malheureusement [adv]
lamentare	[vblex] - déplorer [vblex]
lamentare	[vblex] - plaindre [vblex]
lamentevolmente	[adv] - lamentablement [adv]
lamentevolmente	[adv] - malheureusement [adv]
lampada	[n] - lumière [n.f]
lana	[n] - laine [n]
lanciatore	[n] - lanceur [n]
lanterna	[n] - lanterne [n]
lapide	[n] - pierre tombale [n]
lasciare	[vblex] - laisser [vblex]
laser	[n] - laser [n]
laterale	[adj] - latéral [adj.f]
latino	[n] - latin [adj]
latino	[n] - latin [n]
latitudine	[n] - latitude [n]
latta	[n] - boîte de conserve [n]
latte	[n.m] - lait [n.m]
latte	[n] - lait [n.m]
laurea	[n.f] - licencié [adj]
laureato	[n] - diplômé [n]
laurus nobilis	[n] - laurier [n]
lavabo	[n] - lavabo [n]
lavare	[vblex] - laver [vblex]
lavatrice	[n] - machine à laver [n]
lavorante	[n.mf] - travailleur [adj]
lavorare	[vblex] - bosser [vblex]
lavorativo	[adj] - de travail [adj.mf.sp]
lavoro	[n] - emploi [n.m]
lavoro	[n] - labeur [n.m]
le	[prn.pro.p3.f] - leur [prn.enc.p3.mf.pl]
leader	[n.m.pl] - leader [n]
leader	[n.mf.sp] - leader [n]
lecito	[adj] - licite [adj.mf]
lega	[n] - alliage [n.m]
lega	[n] - lieue [n]
lega	[n] - ligue [n]
legale	[adj] - légal [adj.f]
legalmente	[adv] - légalement [adv]
legamento	[n] - ligament [n]
legare	[vblex] - léguer [vblex]
legge	[n] - loi [n]
leggenda	[n] - légende [n]
leggere	[vblex] - lire [vblex]
leggermente	[adv] - légèrement [adv]
leggero	[adj] - léger [adj]
legislativo	[adj] - législatif [adj]
legislatura	[n] - législature [n]
legislazione	[n] - législation [n]
legittimamente	[adv] - légitimement [adv]
legna	[n] - bois [n.m.sp]
legname	[n.m] - bois [n.m.sp]
legno	[n] - bois [n.m.sp]
lehendakari	[n] - président du pays basque [n]
lens	[n] - lentille [n]
lenta	[n] - lentille [n]
lentamente	[adv] - doucement [adv]
lentamente	[adv] - lentement [adv]
lente	[n] - lentille [n]
lente d'ingrandimento	[n] - loupe [n]
lenticchia	[n] - lentille [n]
lento	[adj] - lent [adj]
lenzuolo	[n] - drap [n.m]
leon	[n] - lion [n]
leone	[n] - lion [n]
lepre	[n] - lièvre [n.m]
lesbismo	[n] - lesbienne [n]
lesione	[n] - lésion [n]
letale	[adj] - létal [adj.f]
letame	[n] - payement [n]
letargo	[n] - hibernation [n]
letargo	[n] - léthargie [n.f]
lettera	[n] - lettre [n]
letterale	[adj] - littéral [adj.f]
letteralmente	[adv] - littéralement [adv]
letterario	[adj] - littéraire [adj.mf]
letteratura	[n] - littérature [n]
letto	[n] - lit [n.m]
letto	[n] - lit [n]
lettura	[n] - lecture [n]
leucemia	[n] - leucémie [n]
leva	[n] - levier [n.m]
lezione	[n] - leçon [n]
liberale	[adj] - libéral [adj.f]
liberalismo	[n] - libéralisme [n]
liberamente	[adv] - librement [adv]
liberare	[vblex] - libérer [vblex]
liberare	[vblex] - relâcher [vblex]
libertinismo	[n] - libertinage [n]
libertà	[n.f.pl] - liberté [n]
libertà	[n.f.sg] - liberté [n]
libertà	[n.f.sp] - liberté [n]
libertà	[n] - liberté [n]
libro	[n] - livre [n]
licenza	[n] - licence [n]
licenziamento	[n] - licenciement [n]
lievemente	[adv] - légèrement [adv]
lima	[n] - lime [n]
limitare	[vblex] - borner [vblex]
limitazione	[n] - limitation [n]
limite	[n.m] - activation [n]
limite	[n] - bord [n.m]
limite	[n] - limite [n.f]
limone	[n] - citron [n]
linea	[n] - ligne [n]
lineare	[adj] - linéaire [adj]
lingua	[n] - langue [n]
lingua catalana	[n] - catalan [adj]
lingua cinese	[n] - chinois [adj.f]
lingua finlandese	[n] - finlandais [adj.f]
lingua galiziana	[n] - galicien [adj]
lingua giapponese	[n] - japonais [adj.f]
lingua inglese	[n] - anglais [adj.f]
lingua latina	[n] - latin [n]
lingua lituana	[n] - lituanien [n]
lingua polacca	[n] - polonais [adj.f]
lingua rumena	[n] - roumain [adj]
linguaggio	[n] - langage [n]
lingue	[n] - idiome [n]
linguistico	[adj] - linguistique [adj.mf]
lino	[n] - lin [n]
linum usitatissimum	[n] - lin [n]
liquidare	[vblex] - liquider [vblex]
liquido	[n] - liquide [adj.mf]
liquore	[n] - liqueur [n.f]
lista	[n] - liste [n]
listare	[vblex] - lister [vblex]
litorale	[adj] - littoral [n]
litorale	[n] - littoral [n]
litro	[n] - litre [n]
lituano	[n] - lituanien [n]
livello	[n] - niveau [n]
livello di base	[n] - embouchure [n]
lo	[prn.pro] - le [detnt]
locale	[adj] - local [adj.f]
locale	[n.mf] - grotte [n]
locale	[n] - local [adj.f]
localizzare	[vblex] - localiser [vblex]
localizzazione	[n] - emplacement [n.m]
locazione	[n.f] - location [n]
locomotiva	[n] - locomotive [n]
logica	[n] - logique [n]
logicamente	[adv] - logiquement [adv]
logico	[adj] - logique [adj.mf]
logistica	[n] - logistique [n]
logistico	[adj] - logistique [adj.mf]
logo	[n] - logotype [n]
londra	[n] - londonien [adj.f]
longitudine	[n] - long [n.m]
lontano	[adv] - loin [adv]
loro	[det.pos.mf.sp] - à il [adj.pos]
lotta	[n] - combat [n]
lotta	[n] - lutte [n]
lotteria	[n] - loterie [n]
lotto	[n] - loterie [n]
luce	[n] - lumière [n.f]
luglio	[n.m.sp] - juillet [n]
luglio	[n] - juillet [n]
lui	[prn.tn.p3.f.sg] - eux [prn.tn.p3.m.pl]
lui	[prn.tn.p3.m.sg] - eux [prn.tn.p3.m.pl]
lui	[prn.tn.p3.mf.pl] - eux [prn.tn.p3.m.pl]
lui	[prn.tn.p3.mf] - eux [prn.tn.p3.m.pl]
luminosità	[n.f.sp] - luminosité [n]
luminosità	[n] - éclat [n]
luminoso	[adj] - lumineux [adj.f]
luna	[n] - lune [n]
lunare	[adj] - lunaire [adj]
lunedì	[n] - lundi [n.m.ND]
lungo	[pr] - le long de [pr]
lungometraggio	[n] - long métrage [n]
luogo	[n] - place [n.f]
lupo	[n] - loup [n.m]
lussuria	[n] - luxure [n]
lustro	[n] - lustre [n]
lynx	[n] - lynx [n.m.sp]
là	[adv] - là-bas [adv]
lì	[adv] - ici [adv]
lì	[adv] - là [adv]
m	[n] - m [n.m]
ma	[cnjcoo] - mais [cnjcoo]
macchinario	[n] - machines [n.f.pl]
macellazione	[n] - tuerie [n]
madre	[n] - maman [n]
madre	[n] - mère [n]
madrid	[n] - madrilène [adj.mf]
madrina	[n] - marraine [n]
maestranze	[n] - personnel [n.m]
maestria	[n] - maîtrise [n]
mafia	[n] - mafia [n]
magazzino	[n] - entrepôt [n]
maggio	[n.m.pl] - mai [n]
maggio	[n.m.sp] - mai [n]
maggio	[n] - mai [n]
maggioranza	[n] - majorité [n.f.pl]
maggiore	[adj] - majeur [adj.f]
maggioritariamente	[adv] - majoritairement [adv]
maggioritario	[adj] - majoritaire [adj.mf]
maggiormente	[adv] - majoritairement [adv]
maghreb	[n] - maghrébin [n.f]
magia	[n] - magie [n]
magistrale	[adj] - magistral [adj.f]
magistralmente	[adv] - magistralement [adv]
magistrato	[n] - juge [n]
magistrato	[n] - magistrat [n]
magnetico	[adj] - magnétique [adj.mf]
magnitudine	[n] - grandeur [n]
mago	[adj] - magique [adj.mf]
magrebino	[adj] - maghrébin [n.f]
mai	[adv] - jamais [adv]
malattia	[n] - affection [n]
malattia	[n] - malade [adj.mf]
malattia	[n] - maladie [n]
malattia	[n] - trouble [n]
male	[adv] - mauvais [adj.m.sp]
male	[n] - mauvais [adj.m.sp]
male	[n] - méchanceté [n]
maledetto	[adj] - maudit [adj]
maledizione	[n] - malédiction [n]
malessere	[n] - malaise [n]
malformazione	[n] - malformation [n]
malgrado	[cnjadv] - lors même que [cnjadv]
malizia	[n] - malice [n]
malizioso	[adj] - malicieux [adj.f]
mamma	[n] - mamelle [n]
mammalia	[n] - mammifère [n]
mammella	[n] - mamelle [n]
mammella	[n] - poitrine [n.f]
mammifero	[n] - mammifère [n]
mancare	[vblex] - manquer [vblex]
mandare	[vblex] - commander [vblex]
mandato	[n] - mandat [n]
mandorla	[n] - amande [n]
mandorlo	[n] - amandier [n]
manga	[n] - manche [n.f]
mangiare	[vblex] - déjeuner [vblex]
mangifera indica	[n] - manche [n.m]
mangime	[n.m] - alimentation [n]
manifestare	[vblex] - manifester [vblex]
manifestazione	[n] - manifestation [n]
manifestazione	[n] - protestation [n]
manipolazione	[n] - manipulation [n]
mano	[n] - main [n]
manoscritto	[n] - manuscrit [adj]
manta	[n] - couverture [n]
mantenere	[vblex] - entretenir [vblex]
manuale	[n] - manuel [adj.f]
manutenzione	[n] - entretien [n]
mappa	[n.f] - carte [n.f]
mappa	[n] - carte [n.f]
maratona	[n] - marathon [n]
marca	[n] - marque [n]
marcare	[vblex] - marquer [vblex]
marcatore	[n] - marqueur [n]
marchese	[n] - marquis [n.f]
marchio	[n.m] - marque [n]
marcia	[n] - marche [n]
marciano	[n] - martien [n]
marciapiede	[n.m] - trottoir [n.m]
marco	[n] - cadre [n]
mare	[n.m] - mer [n.f]
mare	[n] - mer [n.f]
marea	[n] - marée [n]
marginale	[adj] - marginal [adj.f]
margine	[n] - berge [n.f]
marinaio	[n] - marin [n]
marionetta	[n] - marionnette [n.f]
marionetta	[n] - marionnette [n]
marittimo	[adj] - maritime [adj.mf]
marketing	[n] - commercialisation [n]
marketing	[n] - mercatique [n.f]
marmellata	[n] - marmelade [n]
marmo	[n] - marbre [n]
marocchino	[adj] - marocain [adj.f]
marocco	[n] - marocain [adj.f]
marrone	[adj] - marron [adj.mf.sp]
martedì	[n] - mardi [n.m.ND]
martire	[n] - martyr [n.f]
marxismo	[n] - marxisme [n]
marziano	[n] - martien [n]
marzo	[n.m.pl] - mars [n.m.sp]
marzo	[n.m.sp] - mars [n.m.sp]
marzo	[n] - mars [n.m.sp]
maschera	[n] - masque [n.m]
maschio	[n] - mâle [n]
mascolino	[adj] - masculin [adj]
mascotte	[n] - mascotte [n]
massa	[n] - masse [n]
massacro	[n] - massacre [n.m]
massimo	[adj] - maximal [adj]
massivamente	[adv] - massivement [adv]
masturbazione	[n] - masturbation [n]
matematico	[adj] - mathématique [adj.mf]
materasso	[n] - matelas [n.m.sp]
materia	[n.f] - matériel [adj.f]
materia	[n] - matière [n]
materiale	[adj] - matériel [adj.f]
materiale	[n] - matériel [adj.f]
materie plastiche	[n] - plastique [adj.mf]
maternità	[n.f.sp] - maternité [n]
materno	[adj] - maternel [adj.f]
materno	[adj] - maternel [adj]
matina	[n] - demain [adv]
matita	[n] - crayon [n]
matraccio	[n] - flacon [n]
matrice	[n] - matrice [n]
matrimonio	[n] - mariage [n]
matrimonio	[n] - époux [n.f]
mattone	[n] - brique [n.f]
mattutino	[adj] - matinal [adj.f]
maturazione	[n] - maturation [n]
maturità	[n] - maturité [n]
maturo	[adj] - mûr [adj]
mausoleo	[n] - mausolée [n]
me	[prn.tn] - moi [prn.tn]
meco	[prn] - avec moi [prn.tn]
medaglia	[n] - médaille [n]
mediamente	[adv] - moyennement [adv]
mediante	[pr] - moyennant [pr]
mediare	[vblex] - intervenir [vblex]
mediazione	[n] - médiation [n]
medicago sativa	[n] - luzerne [n]
medicina	[n] - médecine [n]
medicina	[n] - médical [adj]
medico	[adj] - médical [adj]
medico	[n] - médical [adj]
medioevale	[adj] - médiéval [adj.f]
meditazione	[n] - méditation [n]
mediterraneo	[adj] - méditerranéen [adj]
megafono	[n] - mégaphone [n]
mela	[n] - pomme [n]
melanzana	[n] - aubergine [n]
melena	[n] - chevelure [n]
melodia	[n] - mélodie [n]
membro	[n] - membre [n]
memoria	[n] - mémoire [n]
memoria	[n] - souvenir [n]
meno	[n] - moins [adv]
mensile	[adj] - mensuel [adj.f]
mensilmente	[adv] - mensuellement [adv]
mentale	[adj] - mental [adj.f]
mentalmente	[adv] - mentalement [adv]
mente	[n] - esprit [n.m]
mentire	[vblex] - mentir [vblex]
mento	[n] - barbiche [n]
mentre	[adv] - tandis que [cnjadv]
mentre	[cnjcoo] - alors que [cnjadv]
mentre	[cnjcoo] - tandis que [cnjadv]
menu	[n] - menu [n]
menzionare	[vblex] - mentionner [vblex]
meraviglioso	[adj] - merveilleux [adj.f]
mercantile	[adj] - mercantile [adj]
mercanzia	[n] - marchandise [n]
mercatino	[n] - braderie [n.f]
mercato	[n] - marché [n]
mercoledì	[n] - mercredi [n.m.ND]
merda	[n] - merde [n]
merito	[n] - mérite [n]
merletto	[n] - pointe [n.f]
mese	[n] - mois [n.m.sp]
messa	[n] - messe [n]
messaggeria	[n] - messagerie [n]
messaggero	[n] - messager [n]
messaggio	[n] - message [n]
mestruazione	[n] - menstruation [n]
meta	[n] - but [n.m]
metafora	[n] - métaphore [n]
metallo	[n] - métal [n]
metamorfosi	[n] - métamorphose [n.f.ND]
meteorite	[n] - météorite [n.f]
meteorologia	[n] - météorologie [n]
meteorologico	[adj] - météorologique [adj.mf]
metodo	[n.m] - forme [n.f]
metodo	[n] - méthode [n]
metro	[n] - m [n.m]
metro	[n] - mètre [n]
metropolitano	[adj] - métropolitain [adj]
metropolitano	[n] - métropolitain [adj]
mettere	[vblex] - brancher [vblex]
metà	[n] - demi [n.m]
mezza notte	[adv] - minuit [adv]
mezzanotte	[n] - minuit [n.m]
mezzo	[n] - moyen [adj]
mi	[prn.pro] - me [prn.enc]
microfono	[n] - microphone [n]
microonde	[n] - micro-onde [n]
microrganismo	[n] - microbe [n]
midollo	[n.m] - moelle [n]
midollo	[n] - moelle [n]
miele	[n] - miel [n.m]
migliaio	[n] - millier [n]
migliaio	[n] - milliers [n]
miglio	[n] - mille [n.m]
migliorare	[vblex] - améliorer [vblex]
migliore	[adj] - meilleur [adj.f]
migliore	[adv] - meilleur [adj.f]
miliardo	[num] - milliard [n]
milione	[n] - million [n]
militare	[adj] - militaire [adj]
militare	[n.m] - militaire [adj]
militarismo	[n] - militarisme [n]
mille	[num] - mil [num.f.sp]
millennio	[n] - millénaire [n]
millimetro	[n] - millimètre [n]
mimesi	[n] - imitation [n]
mina	[n] - mine [n]
minaccia	[n] - intimidation [n]
minaccia	[n] - menace [n]
minestra	[n] - soupe [n]
miniatura	[n] - miniature [n]
miniera	[n] - mine [n]
ministeriale	[adj] - ministériel [adj.f]
ministero	[n] - ministère [n]
ministro	[n] - ministre [n.mf]
minoranza	[n] - minorité [n]
minore	[adj] - moindre [adj]
minore	[n] - moindre [adj]
minuscolo	[adj] - minuscule [adj.mf]
minuto	[n] - minute [n.f]
minuziosamente	[adv] - soigneusement [adv]
mio	[adj.pos] - à moi [adj.pos.mf.sp]
mio	[det.pos.f] - à moi [adj.pos.mf.sp]
mio	[det.pos.m] - à moi [adj.pos.mf.sp]
miracolo	[n] - miracle [n]
miraggio	[n] - mirage [n]
miscela	[n] - mélange [n.m]
miscelare	[vblex] - mélanger [vblex]
mischiare	[vblex] - mélanger [vblex]
miscuglio	[n] - mélange [n.m]
missile	[n] - missile [n.f]
missione	[n] - mission [n]
misterioso	[adj] - mystérieux [adj.f]
misura	[n] - mesure [n]
misurazione	[n] - mesure [n]
mito	[n] - légende [n]
mito	[n] - mythe [n]
mitologia	[n] - mythologie [n]
mittente	[n.m] - transporteur [n.m]
mobile	[adj] - meuble [n]
mobile	[adj] - mobile [adj]
mobile	[n] - meuble [n]
moda	[n] - mode [n.f]
moda	[n] - sobriquet [n]
modale	[adj] - modal [adj.f]
modellismo	[n] - maquette [n]
modello	[n] - maquette [n]
modello	[n] - modèle [n]
modelo	[n] - modèle [n]
modem	[n] - modem [n]
moderare	[vblex] - modérer [vblex]
modernità	[n.f.sp] - modernité [n]
modernizzazione	[n] - modernisation [n]
moderno	[adj] - moderne [adj.mf]
modestia	[n] - modestie [n]
modesto	[adj] - modeste [adj.mf]
modifica	[n] - modification [n]
modificare	[vblex] - modifier [vblex]
modificazione	[n] - modification [n]
modo	[n] - façon [n.f]
modulo	[n] - formulaire [n]
modulo	[n] - module [n]
molecola	[n] - molécule [n]
molestare	[vblex] - déranger [vblex]
molteplice	[adj] - multiple [adj]
moltiplicare	[vblex] - multiplier [vblex]
moltiplicazione	[n] - multiplication [n]
molto	[adj] - beaucoup de [adj.mf.sp]
molto	[adv] - beaucoup de [adj.mf.sp]
molto	[adv] - très [preadv]
molto attentamente	[adv] - étroitement [adv]
molto di meno	[adv] - beaucoup moins [adv]
molto di più	[adv] - beaucoup plus [adv]
molto dopo	[adv] - beaucoup après [adv]
molto meglio	[adv] - beaucoup mieux [adv]
molto meno	[adv] - beaucoup moins [adv]
molto migliore	[adv] - beaucoup mieux [adv]
molto minore	[adv] - beaucoup moins [adv]
molto peggio	[adv] - bien pire [adv]
molto peggiore	[adv] - bien pire [adv]
molto più	[adv] - beaucoup plus [adv]
molto prima	[adv] - beaucoup avant [adv]
momento	[n] - moment [n]
monaco	[n] - religieux [n.f]
monarca	[n] - monarque [n]
monarchia	[n] - monarchie [n]
monastero	[n] - monastère [n]
moncone	[n] - clos [n.m.sp]
mondiale	[adj] - mondial [adj.f]
mondo	[n] - monde [n]
moneta	[n.f] - argent [n.m.sg]
moneta	[n] - monnaie [n]
monetario	[adj] - monétaire [adj.mf]
monitor	[n] - moniteur [n]
monologo	[n] - monologue [n]
monopolio	[n] - monopole [n]
monotono	[adj] - monotone [adj.mf]
montaggio	[n] - montage [n]
montagna	[n] - montagne [n]
montare	[vblex] - monter [vblex]
monte ida	[n] - aller [n.m]
monumentale	[adj] - monumental [adj.f]
monumento	[n] - monument [n]
morale	[adj.mf] - moral [adj.f]
morale	[n] - moral [adj.f]
moralmente	[adv] - moralement [adv]
morire	[vblex] - décéder [vblex]
morire	[vblex] - mourir [vblex]
moro	[adj] - maure [n.mf]
moro	[n] - maure [n.mf]
mortale	[adj] - mortel [adj.f]
mortale	[n] - mortel [adj.f]
mortalità	[n.f.sp] - mortalité [n]
morte	[n] - décès [n.m.sp]
morte	[n] - mort [n.f]
morto	[adj] - mort [adj]
morto	[n] - mort [adj]
mosca	[n] - mouche [n]
moschea	[n] - mosquée [n]
mostrare	[vblex] - montrer [vblex]
mostro	[n] - monstre [n]
motivare	[vblex] - motiver [vblex]
moto	[n] - moto [n]
motocicletta	[n] - moto [n]
motocicletta	[n] - motocyclette [n]
motociclismo	[n] - motocyclisme [n]
motore	[n] - moteur [n]
motore di ricerca	[n] - moteur de recherche [n]
motto	[n] - devise [n.f]
movimento	[n.m] - mouvement [n]
movimento	[n] - mouvement [n]
mucchio	[n] - amas [n.m.sp]
mulino	[n] - moulin [n]
multa	[n] - amende [n]
multicultural	[adj] - multiculturel [adj.f]
multinazionale	[n] - multinationale [n]
multiplo	[adj] - multiple [adj]
mummia	[n] - momie [n]
municipale	[adj] - municipal [adj.f]
municipio	[n] - commune [n.f]
munizione	[n] - munition [n]
munizioni	[n] - balle [n]
munizioni	[n] - munition [n]
murale	[adj] - peinture murale [n.f]
muratore	[n] - maçon [n.f]
muratura	[n] - mur [n.m]
muro	[n] - mur [n]
musa	[n] - muse [n]
muscolare	[adj] - musculaire [adj]
muscolo	[n] - muscle [n]
museo	[n] - musée [n]
musica	[n] - musique [n]
musica pop	[n] - pop [n]
musicale	[adj] - musical [adj.f]
musicale	[n] - musical [adj.f]
musicalmente	[adv] - musicalement [adv]
musicista	[n] - musicien [n]
musulmano	[n] - musulman [adj]
mutazione	[n] - mutation [n]
mutilazione	[n] - mutilation [n]
muto	[n] - muet [adj]
mutuamente	[adv] - l'un de l'autre [adv]
mutuo	[adj] - mutuel [adj]
n	[n] - n [n.m]
nafta	[n] - gasoil [n]
narice	[n] - nez [n.m.sp]
narrare	[vblex] - narrer [vblex]
narratore	[n] - narrateur [n]
nascondere	[vblex] - cacher [vblex]
naso	[n.m] - nez [n.m.sp]
natale	[adj] - natal [adj.f]
natale	[n] - noël [n.m.sp]
natiche	[n] - cul [n]
natiche	[n] - de derrière [adj.mf.sp]
natiche	[n] - fesse [n]
nativo	[adj] - natif [adj]
natura	[n] - nature [n]
naturale	[adj] - naturel [adj.f]
naturalmente	[adv] - naturellement [adv]
naufragare	[vblex] - naufrager [vblex]
naufragio	[n] - naufrage [n]
navale	[adj] - naval [adj.f]
nave	[n.f] - bateau [n]
nave	[n] - bateau [n]
nave	[n] - navire [n.m]
navigare	[vblex] - naviguer [vblex]
navigazione	[n.f] - positionnement [n]
navigazione	[n] - navigation [n]
nazionale	[adj] - national [adj.f]
nazionalismo	[n] - nationalisme [n]
nazionalista	[n.m] - nationaliste [adj]
nazionalista	[n] - nationaliste [adj]
nazionalsocialismo	[n] - nazi [n.f]
nazionalsocialismo	[n] - nazisme [n]
nazione	[n] - nation [n]
ne	[prn.pro.adv] - y [prn.enc.adv]
neanche	[adv] - même pas [adv]
neanche	[adv] - non plus [adv]
nebbia	[n] - brouillard [n.m]
necessariamente	[adv] - nécessairement [adv]
necessitare	[vblex] - nécessiter [vblex]
necessità	[n.f.sp] - besoin [n.m]
necropoli	[n] - nécropole [n.f.ND]
nederlandese	[n] - hollandais [adj.f]
negare	[vblex] - nier [vblex]
negativamente	[adv] - négativement [adv]
negazione	[n] - négation [n]
negozio	[n] - magasin [n.m]
nel caso in cui	[adv] - au cas où [cnjadv]
nel caso in cui	[adv] - de sorte que [cnjadv]
nel frattempo	[adv] - en attendant [adv]
nella misura in cui	[cnjadv] - tandis que [cnjadv]
nemico	[n] - ennemi [adj]
nemmeno	[adv] - même pas [adv]
neo	[n] - lunaire [adj]
neoliberale	[adj] - néolibéral [adj.f]
neonato	[n] - bébé [n]
neppure	[adv] - au moins [adv]
neppure	[adv] - même pas [adv]
nero	[adj] - nègre [adj.mf]
nero	[n] - nègre [adj.mf]
nervo	[n] - nerf [n]
nervoso	[adj] - nerveux [adj.f]
nessuno	[det.ind] - aucun [det.ind]
nessuno	[prn.tn.f] - aucun [det.ind]
nessuno	[prn.tn.m] - aucun [det.ind]
nessuno	[prn.tn.m] - aucun [prn.tn.f.sg]
nessuno	[prn] - aucun [det.ind]
neurone	[n] - neurone [n]
neve	[n] - neige [n]
nevischio	[n] - neige fondue [n]
nicotina	[n] - nicotine [n]
nido	[n] - nid [n]
niente	[prn] - rien [prn.tn.nt]
nigeriano	[adj] - nigérien [n]
nigeriano	[n] - nigérien [n]
no	[adv] - ne [adv]
nobiltà	[n] - noblesse [n]
noce	[n] - noix [n.f.sp]
nodo	[n] - noeud [n]
noi	[prn.tn.p1.mf] - nous [prn.tn.p1.mf]
nomade	[adj] - nomade [n]
nomade	[n] - nomade [n]
nome	[n] - nom [n]
nomina	[n] - nomination [n.f]
nominare	[vblex] - nominer [vblex]
nominare	[vblex] - nommer [vblex]
nomination	[n] - nomination [n]
non	[adv] - ne [adv]
noncuranza	[n] - négligence [n]
nonno	[n] - grand-mère [n.f]
nono	[adj] - neuvième [adj.mf]
nonostante	[cnjsub] - cependant [cnjadv]
nonostante	[pr] - en dépit de [pr]
nord	[n] - nord [n]
norma	[n] - norme [n]
normale	[adj] - normal [adj.f]
normalità	[n] - normalité [n]
normalizzazione	[n] - normalisation [n]
normalmente	[adv] - normalement [adv]
normativo	[adj] - normatif [adj]
norvegese	[adj] - norvégien [adj]
norvegese	[n] - norvégien [adj]
nostalgia	[n] - nostalgie [n]
nostro	[adj.pos] - à nous [adj.pos.mf.sp]
nostro	[det.pos] - à nous [adj.pos.mf.sp]
nota	[n] - note [n]
notaio	[n] - notaire [n.mf]
notare	[vblex] - remarquer [vblex]
notarile	[adj] - notarial [adj.f]
notevolmente	[adv] - considérablement [adv]
notevolmente	[adv] - notablement [adv]
notifica	[n] - avis [n.m.sp]
notifica	[n] - faire-part [n.m.sp]
notificare	[vblex] - notifier [vblex]
notizia	[n] - dépêche [n]
notte	[n] - nuit [n]
nove	[num] - neuf [num]
novellino	[n] - novice [adj.mf]
novembre	[n.m.pl] - novembre [n]
novembre	[n.m.sp] - novembre [n]
nozze	[n] - mariage [n.m]
nube	[n] - nuage [n.m]
nucleare	[adj] - nucléaire [adj]
nucleo	[n] - noyau [n]
nudo	[adj] - nu [adj]
nulla	[prn] - rien [prn.tn.nt]
numero	[n] - nom [n]
numero	[n] - nombre [n]
numero primo	[n] - premier [adj]
nuora	[n] - belle-fille [n]
nuotare	[vblex] - nager [vblex]
nuoto	[n] - nage [n]
nuovamente	[adv] - de nouveau [adv]
nuovo	[adj] - neuf [adj]
nutrizione	[n] - nutrition [n]
nuvola	[n] - nuage [n.m]
né	[cnjcoo] - ni [cnjcoo]
o	[cnjcoo] - ou [cnjcoo]
obbligatoriamente	[adv] - forcément [adv]
obbligazione	[n] - obligation [n]
obbligo	[n.m] - obligation [n]
obesità	[n.f.sp] - obésité [n]
obiettivo	[adj] - objectif [adj]
obiettivo	[n] - objectif [adj]
obiezione	[n] - objection [n.f]
oblio	[n] - oubli [n]
obsoleto	[adj] - obsolète [adj.mf]
oca	[n] - empoté [adj]
occasionalmente	[adv] - occasionnellement [adv]
occhio	[n] - oeil [n]
occidentale	[adj] - occidental [adj.f]
occidente	[n] - occident [n]
occultamento	[n.m] - occultation [n]
occultazione	[n] - occultation [n]
occupare	[vblex] - occuper [vblex]
occupazione	[n] - occupation [n.f]
oceano	[n] - océan [n]
octopus vulgaris	[n] - poulpe [n]
odio	[n] - haine [n.f]
odioso	[adj] - odieux [adj.f]
odissea	[n] - odyssée [n]
odontoiatria	[n] - odontologie [n]
odore	[n] - odeur [n.f]
offerta	[n] - offre [n]
offrire	[vblex] - offrir [vblex]
oganismo	[n] - organisme [n]
oggetto	[n] - objet [n]
oggi	[adv] - aujourd'hui [adv]
oggigiorno	[adv] - aujourd'hui [adv]
ogni	[det.ind] - chaque [det]
ogni tanto	[adv] - de temps en temps [adv]
ogni volta	[adv] - chaque fois [cnjadv]
ogni volta di più	[adv] - de plus en plus [adv]
ognuno	[prn.tn.GD] - chacun [prn]
ognuno	[prn] - chacun [prn]
olandese	[n] - hollandais [adj.f]
olea europaea	[n] - olivier [n]
olfatto	[n] - flair [n]
olimpiade	[n] - olympiade [n]
olimpico	[adj] - olympique [adj.mf]
olio	[n] - huile [n.f]
oliva	[n] - olive [n.m]
olivo	[n] - olivier [n]
olocausto	[n] - holocauste [n]
oltre	[adv] - au delà [adv]
oltre	[pr] - au-delà de [pr]
omaggio	[n] - hommage [n]
ombelicale	[adj] - ombilical [adj.f]
ombelico	[n] - nombril [n]
ombra	[n] - ombre [n]
ombrello	[n] - parapluie [n.m.ND]
omicidio	[n] - assassinat [n]
omicidio	[n] - meurtre [n]
omofobia	[n] - homophobie [n]
omologazione	[n] - homologation [n]
omosessuale	[adj] - homosexuel [n.f]
omosessuale	[n] - homosexuel [n.f]
omosessualità	[n.f.sp] - homosexualité [n]
omosessualità	[n] - homosexuel [n.f]
on line	[adv] - en ligne [adj]
onda marina	[n] - vague [n]
ondata	[n] - vague [n]
onesto	[adj] - honnête [adj.mf]
onorario	[n] - honoraire [adj.mf]
onoratamente	[adv] - honnêtement [adv]
onore	[n] - honneur [n.m]
onore	[n] - honneur [n]
onorifico	[adj] - honorifique [adj.mf]
opera	[n] - opéra [n.m]
opera lirica	[n] - opéra [n.m]
operaio	[adj] - ouvrier [adj]
operaio	[n] - ouvrier [adj]
operare	[vblex] - opérer [vblex]
operato	[n] - chantier [n.m]
operatore	[n] - opérateur [n]
operazione	[n] - operation [n]
opinare	[vblex] - opiner [vblex]
opinione	[n] - opinion [n]
oppositore	[n] - opposant [adj]
opposizione	[n] - opposition [n]
opposto	[adj] - opposé [adj]
optare	[vblex] - opter [vblex]
opuscolo	[n] - brochure [n.f]
opzionale	[adj] - optionnel [adj.f]
ora	[n] - heure [n]
orafo	[n] - orfèvre [n]
orale	[adj] - oral [adj.f]
orario	[adj] - horaire [adj.mf]
orario	[n] - horaire [adj.mf]
orbita	[n] - orbite [n]
orchestra	[n] - orchestre [n.m]
ordinanza	[n] - ordonnance [n]
ordinare	[vblex] - commander [vblex]
ordinare	[vblex] - ordonner [vblex]
ordinario	[adj] - ordinaire [adj.mf]
ordine	[n.m] - mandat [n.m]
ordine	[n] - mandat [n.m]
orecchino	[n.m] - pendant [adj.f]
orecchio	[n.m] - oreille [n]
orecchio	[n] - oreille [n]
orfano	[adj] - orphelin [adj]
orfano	[n] - orphelin [adj]
orfanotrofio	[n] - orphelin [adj]
organismo	[n.m] - établissement [n.m]
organizzare	[vblex] - organiser [vblex]
organizzazione	[n] - organisation [n]
organo	[n] - organe [n]
orgasmo	[n] - orgasme [n]
orgia	[n] - orgie [n]
orgoglio	[n] - orgueil [n]
orientale	[adj] - oriental [adj.f]
orientamento	[n] - orientation [n]
orientare	[vblex] - aiguiller [vblex]
oriente	[n] - orient [n]
originale	[adj] - original [adj.f]
originario	[adj] - originaire [adj.mf]
origine	[n] - naissance [n.f]
origine	[n] - origine [n.f]
orina	[n] - urine [n]
orizzontale	[adj] - horizontal [adj.f]
orizzontale	[n] - horizontal [adj.f]
orizzonte	[n] - horizon [n]
ormone	[n.m] - hormone [n]
ormone	[n] - hormone [n]
oro	[n] - or [n]
orografia	[n] - orographie [n]
orologio	[n] - horloge [n.f]
orrore	[n] - horreur [n.f]
orso	[n] - ours [n.f]
ortaggio	[n.m] - légume [n.m]
orto	[n] - verger [n.m]
orto	[n] - verger [n]
ortografia	[n] - ortographie [n]
oscillare	[vblex] - osciller [vblex]
oscillazione	[n] - oscillation [n]
oscini	[n] - oiseau [n]
oscurità	[n.f.sp] - obscurité [n]
ospedale	[n] - hôpital [n]
ospite	[n] - hôte [n]
osservare	[vblex] - observer [vblex]
osservatore	[n] - observateur [adj]
osservazione	[n] - observation [n]
ossia	[cnjadv] - c'est-à-dire [cnjadv]
ossidazione	[n] - oxydation [n]
ossido di calcio	[n] - chaux [n.f.sp]
ossigeno	[n] - oxygène [n]
osso	[n] - os [n.m.sp]
ostacolo	[n] - obstacle [n]
ostensorio	[n] - garde [n]
ostile	[adj] - hostile [adj]
ottenere	[vblex] - obtenir [vblex]
ottico	[adj] - optique [adj.mf]
ottimismo	[n] - optimisme [n]
otto	[num] - huit [num]
ottobre	[n.m.pl] - octobre [n]
ottobre	[n.m.sp] - octobre [n]
ovest	[n] - ouest [n]
ovis	[n] - mouton [n.m]
ovviamente	[adv] - bien sûr [adv]
ovviamente	[adv] - évidemment [adv]
ozio	[n] - loisir [n]
ozono	[n] - ozone [n]
pacchetto	[n.m] - colis [n.m.sp]
pace	[n] - paix [n.f.sp]
pachistano	[adj] - pakistanais [n.GD]
pacifico	[adj] - pacifique [adj.mf]
pacifismo	[n] - pacifisme [n]
pacifista	[n] - pacifiste [adj]
package	[n] - colis [n.m.sp]
padiglione auricolare	[n] - oreille [n]
padre	[n] - père [n]
padrino	[n] - parrain [n]
paella	[n] - poêle [n]
paesaggio	[n] - paysage [n]
paese	[n] - pays [n.m.sp]
paganesimo	[n] - païen [adj]
pagano	[n] - païen [adj]
pagare	[vblex] - appointer [vblex]
pagina	[n] - page [n]
paglia	[n] - paille [n]
pakistan	[n] - pakistanais [adj.m.sp]
pala	[n] - pelle [n]
palazzo	[n] - palais [n.m.sp]
palco	[n] - halle [n.m]
palco	[n] - plateau [n]
palcoscenico	[n] - plateau [n]
palinsesto	[n.m] - gril [n.m]
palla	[n] - ballon [n.m]
palla	[n] - boule [n]
pallacanestro	[n] - auvent [n]
pallacanestro	[n] - basket-ball [n]
pallamano	[n] - handball [n]
pallanuoto	[n] - water-polo [n]
pallavolo	[n] - volley-ball [n]
pallet	[n] - palette [n]
pallido	[adj] - pâle [adj.mf]
pallone	[n] - ballon [n]
palma	[n] - empan [n]
palma	[n] - palmier [n.m]
palma	[n] - paume [n]
palo	[n] - bâton [n]
palpebra	[n] - paupière [n.f]
palude	[n.f] - marais [n.m.sp]
palude	[n] - marais [n.m.sp]
pamphlet	[n] - pamphlet [n]
panca	[n] - canapé [n]
pancia	[n.f] - abdomen [n]
pancia	[n] - ventre [n.m]
pancreas	[n] - pancréas [n]
panda	[n] - panda [n]
pane	[n] - pain [n]
panel	[n] - panneau [n]
panettiere	[n] - boulanger [n]
panfilo	[n] - yacht [n]
panico	[n] - panique [n]
paniere	[n.m] - corbeille [n]
pannello	[n] - panneau [n]
panorama	[n] - panorama [n]
papa	[n] - pape [n]
papale	[adj] - papal [adj.f]
pappagallino	[n] - perruche [n.f]
pappagallo	[n] - perroquet [n]
papà	[n] - papa [n]
paracadute	[n] - parachute [n.m.ND]
paracadutismo	[n] - parachutisme [n]
paradigma	[n] - paradigme [n]
paradosso	[n] - paradoxe [n.m]
paragrafo	[n] - paragraphe [n]
paraguay	[n] - paraguayen [n]
paralisi	[n] - paralysie [n.f.ND]
parametro	[n] - paramètre [n]
paranoia	[n] - paranoïa [n]
parassita	[n] - parasite [adj.mf]
paratoia	[n] - pale [n]
parcheggio	[n] - garage [n]
parcheggio	[n] - stationnement [n]
parco	[n] - parc [n]
parecchio	[adj.ind] - beaucoup de [adj.mf.sp]
pareggio	[n] - ballottage [n]
pareja	[n] - couple [n.m]
parente	[n] - parent [n.f]
parentesi	[n] - parenthèse [n.f.ND]
parere	[vblex] - avis [n.m.sp]
parlamentare	[adj.mf] - parlementaire [adj.mf]
parlamento	[n] - parlement [n]
parlare	[vblex] - parler [vblex]
parola	[n] - langue [n]
parola	[n] - mot [n.m]
parroco	[n] - vicaire [n]
parrucca	[n] - perruque [n]
parrucchiere	[n] - coiffeur [n]
parte	[n] - part [n.f]
partecipante	[n] - participant [adj.f]
partecipare	[vblex] - participer [vblex]
partecipazione	[n] - participation [n]
particella	[n] - particule [n]
participio	[n] - participe [n]
particolare	[adj] - particulier [adj.f]
particolarmente	[adv] - particulièrement [adv]
partire	[vblex] - partir [vblex]
partito	[n] - match [n]
partito laburista	[n] - travailliste [adj]
parto	[n] - partie [n.m]
parziale	[adj] - partiel [adj.f]
parzialmente	[adv] - partiellement [adv]
passaporto	[n] - passeport [n]
passato	[n] - passé [n]
passeggero	[adj] - passager [adj]
passeggio	[n] - balade [n.f]
passione	[n] - passion [n]
passivo	[adj] - passif [adj]
passo	[n] - pas [n.m.sp]
password	[n] - mot de passe [n.m]
pasta	[n] - pâte [n]
pasto	[n] - pâturage [n]
pasto	[n] - repas [n.m.sp]
pastoral	[adj] - pastoral [adj.f]
pastore	[n] - berger [n]
patata	[n] - pomme de terre [n]
patch	[n] - actualisation [n]
patch	[n] - rustine [n.f]
patologia	[n] - pathologie [n]
patria	[n] - patrie [n]
patriarca	[n] - patriarche [n]
patrimoniale	[adj] - patrimonial [adj.f]
patrimonio	[n] - patrimoine [n]
patrocinio	[n] - patronage [n]
patronale	[adj] - patronal [adj.f]
pattinaggio	[n] - patinage [n]
paulatinamente	[adv] - lentement [adv]
paura	[n.f] - peur [n.f]
paura	[n] - peur [n.f]
pavimento	[n] - appartement [n]
pavimento	[n] - dallage [n]
pazientemente	[adv] - patiemment [adv]
pecora	[n] - mouton [n.m]
pedaggio	[n] - péage [n]
pedagogia	[n] - pédagogie [n]
pedalata	[n.f] - pédalage [n]
pederastia	[n] - pédéraste [n]
pediatra	[n] - pédiatre [n]
pediatria	[n] - pédiatre [n]
pedone	[n] - piéton [n]
peggiorare	[vblex] - empirer [vblex]
peggiore	[adj] - pis [adj.mf.sp]
pelle	[n] - fourrure [n.f]
pellegrinaggio	[n] - pèlerinage [n.m]
pellegrino	[adj] - pèlerin [adj]
pellicola	[n] - film [n.m]
pelo	[n] - poil [n]
pena	[n] - peine [n]
pena di morte	[n] - execution [n]
penale	[adj] - pénal [adj.f]
pendere	[vblex] - pendre [vblex]
pene	[n] - pénis [n.m.sp]
penetrare	[vblex] - pénétrer [vblex]
penetrazione	[n] - pénétration [n]
peninsulare	[adj] - péninsulaire [adj]
penisola	[n] - péninsule [n]
pennello	[n] - pinceau [n]
pensare	[vblex] - aviser [vblex]
pensionato	[n.m] - pensionnaire [n]
pensione	[n] - jubilation [n]
pensione	[n] - pension [n]
pentagramma	[n] - portée [n.f]
pentola	[n] - marmite [n]
penultimo	[adj] - avant-dernier [adj]
pepe	[n.m] - poivre [n.m]
pepe	[n] - poivre [n.m]
peperone	[n] - poivron [n]
per	[n] - pair [adj.f]
per	[pr] - envers [pr]
per	[pr] - par [pr]
per	[pr] - pour [pr]
per adesso	[adv] - pour l'instant [adv]
per cento	[adv] - pour cent [adv]
per dire alla verità	[adv] - franchement [adv]
per evitare	[adj] - préventif [adj.f]
per intero	[adv] - complètement [adv]
per lo meno	[adv] - au moins [adv]
per magia	[adv] - comme par enchantement [adv]
per ora	[adv] - pour l'instant [adv]
per regolare	[adv] - régulier [adj.f]
percento	[adv] - pour cent [adv]
percentuale	[adj] - en pourcentage [adj.mf.sp]
percentuale	[n] - pourcentage [n]
percezione	[n] - aperçu [n.m]
perché	[adv] - car [cnjadv]
perdere	[vblex] - perdre [vblex]
perdita	[n] - déchet [n.m.sg]
perdonare	[vblex] - pardonner [vblex]
perdono	[n] - pardon [n]
perfettamente	[adv] - parfaitement [adv]
perforazione	[n] - forage [n.m]
pericolo	[n] - danger [n]
pericolosamente	[adv] - dangereusement [adv]
pericoloso	[adj] - dangereux [adj.f]
periferico	[adj] - périphérique [adj.mf]
perimetro	[n] - périmètre [n]
periodicamente	[adv] - périodiquement [adv]
periodico	[adj] - périodique [adj.mf]
periodo	[n.m] - chronologie [n]
periodo	[n] - période [n.f]
perla	[n] - perle [n]
perlomeno	[adv] - au moins [adv]
permanentemente	[adv] - en permanence [adv]
permanere	[vblex] - demeurer [vblex]
permesso	[n] - permis [n.m.sp]
perpetrare	[vblex] - perpétrer [vblex]
persecuzione	[n] - persécution [n]
perseguire	[vblex] - courser [vblex]
perseveranza	[n] - insistance [n]
persiana	[n] - persienne [n]
persiano	[adj] - persan [adj.f]
persiano	[n] - persan [adj.f]
persistenza	[n] - persistance [n]
persona	[n] - personne [n]
personaggio	[n] - personnage [n]
personale	[adj] - personnel [adj.f]
personale	[n] - personnel [adj.f]
personali	[adj] - personnel [adj.f]
personalità	[n.f.sp] - personnalité [n]
personalmente	[adv] - personnellement [adv]
pertanto	[adv] - donc [cnjadv]
pertanto	[cnjadv] - donc [cnjadv]
pertica	[n.f] - poteau [n]
perturbazione	[n.f] - désajustement [n]
perù	[n] - péruvien [adj]
pesare	[n] - peser [vblex]
pesare	[vblex] - peser [vblex]
pesca	[n] - pêche [n]
pescatore	[n] - pêcheur [adj]
pesce	[n] - poisson [n]
pesci	[n] - poisson [n]
peseta spagnola	[n] - peseta [n]
peso	[n] - poids [n.m.sp]
pessimismo	[n] - pessimisme [n]
pessimista	[n] - pessimiste [n]
peste	[n] - peste [n]
petizione	[n] - demande [n]
petrolio	[n] - pétrole [n]
petto	[n] - poitrine [n.f]
pezzetto	[n] - morceau [n]
pezzo	[n.m] - pièce [n]
phocidae	[n] - phoque [n.m]
phylum	[n] - fil [n]
piacere	[n] - plaisir [n]
piacere	[vblex] - plaire [vblex]
piaga	[n] - plaie [n]
pianeta	[n] - planète [n.f]
piangere	[vblex] - pleurer [vblex]
pianificazione	[n] - planification [n]
pianista	[n] - pianiste [n]
piano	[adv] - doucement [adv]
piano	[n] - plan [n]
piano	[n] - plat [adj]
pianoforte	[n] - piano [n]
pianta	[n] - plante [n]
piantare	[vblex] - planter [vblex]
pianura	[n] - plaine [n]
piatto	[n] - assiette [n.f]
piatto	[n] - soucoupe [n.f]
piazza	[n] - poste [n.m]
piccione	[n.m] - pigeon [n]
picco	[n] - pioche [n.f]
piccolo	[adj] - petit [adj]
pico	[n] - pioche [n.f]
piede	[n] - pied [n]
piedistallo	[n] - piédestal [n]
piega	[n] - pli [n]
pienamente	[adv] - pleinement [adv]
pietà	[n.f.sp] - piété [n]
pigro	[n] - paresseux [adj.f]
pilastro	[n] - pilier [n]
pilota	[n] - pilote [n]
pinacoteca	[n] - pinacothèque [n]
pinguino	[n] - pingouin [n]
pino	[n] - pin [n]
pioggia	[n] - pluie [n]
pionero	[n] - pionnier [adj]
piovere	[vblex] - pleuvoir [vblex]
pipa	[n] - pipe [n]
piramide	[n] - pyramide [n]
pirateria	[n] - pirate [adj]
pirateria	[n] - piraterie [n]
piscina	[n] - piscine [n]
pista	[n] - piste [n]
pistola	[n] - pistolet [n.m]
pittore	[n] - peintre [n.mf]
piuma	[n] - plume [n]
piuttosto	[adv] - assez [adv]
piuttosto	[adv] - plutôt [adv]
pizza	[n] - pizza [n]
più	[adv] - davantage [adv]
placca	[n] - plaque [n]
plan	[n] - plat [adj]
plancton	[n] - plancton [n]
planetario	[n] - planétaire [adj.mf]
plantae	[n] - plante [n]
plantae	[n] - végétation [n]
plasmare	[vblex] - refléter [vblex]
plastica	[n.f] - plastique [adj.mf]
plastica	[n] - plastique [adj.mf]
platino	[n] - platine [n]
plebei	[n] - plébéien [n]
pletora	[n] - abondance [n]
plurale	[adj] - pluriel [adj.f]
plurale	[n] - pluriel [adj.f]
pluriennale	[adj] - pluriannuel [adj.f]
pluviale	[adj] - pluvial [adj.f]
pneumatico	[n] - caoutchouc [n]
pneumatico	[n] - pneumatique [n]
poco	[adv] - peu de [adj.mf.sp]
poco	[det.ind] - peu de [adj.mf.sp]
poco	[prn.tn] - peu de [adj.mf.sp]
poco a poco	[adv] - au fur et à mesure [adv]
podere	[n] - propriété [n]
poderosamente	[adv] - puissamment [adv]
poderoso	[adj] - puissant [adj]
poema	[n] - poème [n]
poesia	[n] - poésie [n]
poeta	[n] - poète [n.f]
poiché	[cnjsub] - depuis que [cnjadv]
polacco	[n] - polonais [adj.f]
polare	[adj] - polaire [adj]
polemica	[n] - polémique [n]
poligamia	[n] - polygamie [n]
poligono	[n] - polygone [n]
politica	[n] - politique [n]
politicamente	[adv] - politiquement [adv]
politico	[adj] - politique [adj.mf]
politico	[n] - politique [adj.mf]
polizia	[n] - police [n.f]
poliziesco	[adj] - policier [adj.f]
polizza	[n] - police [n]
pollice	[n] - pouce [n.m]
polline	[n] - pollen [n]
pollo	[n] - poulet [n]
polmone	[n] - poumon [n]
polmonite	[n] - pneumonie [n]
polo	[n] - pôle [n]
polso	[n] - poignet [n.m]
polvere	[n] - poussière [n.f]
polvere nera	[n] - poudre [n]
ponderare	[vblex] - pondérer [vblex]
ponte	[n] - pont [n]
pop	[n] - pop [n]
popolare	[adj] - populaire [adj]
popolarmente	[adv] - populairement [adv]
popolazione	[n] - population [n]
popoli indigeni	[n] - indigène [adj]
poppa	[n] - poupe [n]
porco	[n] - cochon [adj]
pornografia	[n] - porno [adj]
pornografia	[n] - pornographie [n]
porre	[vblex] - brancher [vblex]
porta	[n] - porte [n]
portafoglio	[n.m] - facteur [n.f]
portare	[vblex] - amener [vblex]
portare	[vblex] - emporter [vblex]
portare	[vblex] - porter [vblex]
portata	[n.f] - portée [n.f]
portata	[n] - capital [n]
portatile	[adj] - portable [adj]
portatore	[n] - porteur [n]
portavoce	[n] - porte-parole [n.mf.sp]
portiere	[n] - portier [n]
portinaio	[n.m] - concierge [n]
porto	[n] - port [n]
portoghese	[adj] - portugais [adj.f]
porzione	[n] - portion [n]
posare	[vblex] - poser [vblex]
positivamente	[adv] - positivement [adv]
posizionamento	[n] - positionnement [n]
posizione	[n] - position [n]
possesso	[n] - possession [n]
possibilità	[n.f.sp] - occasion [n]
possibilità	[n.f.sp] - possibilité [n]
possibilmente	[adv] - vraisemblablement [adv]
possibilmente	[adv] - éventuellement [adv]
posta	[n] - courrier [n]
poster	[n] - affiche [n.f]
poster	[n] - poster [n]
posteriore	[adj] - arrière [adj.mf.sp]
posteriormente	[adv] - postérieurement [adv]
postino	[n] - facteur [n.f]
postumi dell'ubriachezza	[n] - ressac [n.m]
postura	[n] - position [n]
potabile	[adj] - potable [adj]
potassio	[n] - potassium [n]
potenza	[n] - exposant [adj.f]
potenza	[n] - puissance [n]
potenziale	[adj] - potentiel [adj.f]
potenziale	[n] - potentiel [adj.f]
potenzialmente	[adv] - potentiellement [adv]
potere	[n.m] - forteresse [n]
potere	[n.m] - puissance [n]
potere	[n] - pouvoir [n]
potere	[vbmod] - pouvoir [n]
povertà	[n] - indigence [n]
povertà	[n] - pauvreté [n]
pozzanghera	[n] - flaque [n.f]
pozzo	[n] - puits [n.m.sp]
pranzo	[n] - petit-déjeuner [n]
pranzo	[n] - repas [n.m.sp]
praticamente	[adv] - pratiquement [adv]
precedente	[n] - précédent [adj.f]
precedentemente	[adv] - antérieurement [adv]
precedere	[vblex] - précéder [vblex]
precipitare	[vblex] - précipiter [vblex]
precipitazione	[n] - précipitation [n]
precipizio	[n] - précipice [n]
precisamente	[adv] - précisément [adv]
precisare	[vblex] - préciser [vblex]
preciso	[adj] - ponctuel [adj.f]
preciso	[adj] - précis [adj.f]
predicare	[vblex] - prêcher [vblex]
predisposizione	[n] - prédisposition [n]
preferibile	[adj] - préférable [adj]
preferibilmente	[adv] - de préférence [adv]
preferibilmente	[adv] - préférablement [adv]
pregare	[vblex] - prier [vblex]
pregare	[vblex] - supplier [vblex]
pregiudizievole	[adj] - nuisible [adj]
pregiudizio	[n] - préjugé [n]
preistoria	[n] - préhistoire [n]
prelievo	[n] - extraction [n]
preliminare	[adj] - préliminaire [adj]
preludio	[n] - prélude [n]
premessa	[n] - prémisse [n]
premiare	[vblex] - décerner un prix [vblex]
premio	[n] - prix [n.m.sp]
prendere	[vblex] - prendre [vblex]
prenotare	[vblex] - réserver [vblex]
preoccupante	[adj] - préoccupant [adj.f]
preoccupazione	[n] - or [n]
preoccupazione	[n] - souci [n.m]
preparare	[vblex] - préparer [vblex]
preparatorio	[adj] - préparatoire [adj.mf]
preposizione	[n] - préposition [n]
presbitero	[n] - prêtre [n]
presbitero	[n] - soin [n.m]
prescrizione	[n] - prescription [n]
presentare	[vblex] - présenter [vblex]
presentatore televisivo	[n] - montreur [n]
presentazione	[n] - présentation [n]
presente	[adj] - actuel [adj.f]
presente	[n] - présent [adj.f]
preservare	[vblex] - préserver [vblex]
presidente	[n.mf] - président [n]
presidente	[n] - président [n]
presidenziale	[adj] - présidentiel [adj.f]
pressione	[n] - pression [n]
presso	[pr] - près [pr]
prestare	[vblex] - prêter [vblex]
prestigioso	[adj] - prestigieux [adj.f]
presto	[adv] - bientôt [adv]
presto	[adv] - tôt [adv]
presuntamente	[adv] - par présomption [adv]
prete	[n] - soin [n.m]
pretendere	[vblex] - prétendre [vblex]
pretesa	[n] - prétention [n]
prevalere	[vblex] - primer [vblex]
prevedere	[vblex] - prévoir [vblex]
prevenire	[vblex] - prévenir [vblex]
prevenzione	[n] - prévention [n.f]
previamente	[adv] - préalablement [adv]
previo	[adj] - préalable [adj.mf]
previsibilmente	[adv] - de façon prévisible [adv]
previsioni	[n] - prédiction [n]
prezioso	[adj] - précieux [adj.f]
prezzo	[n] - prix [n.m.sp]
pricipalmente	[adv] - notamment [adv]
pricipalmente	[adv] - principalement [adv]
prigione	[n] - prison [n]
prigione	[n] - prisonnier [n]
prigione	[n] - reclus [n.f]
prima	[adv] - auparavant [adv]
prima	[adv] - devant [pr]
prima che	[cnjadv] - avant que [cnjadv]
primamente	[adv] - d'abord [adv]
primates	[n] - primate [n]
primavera	[n] - printemps [n.m.sp]
primo	[adj] - premier [adj]
primo	[adv] - premier [adj]
principale	[adj] - principal [adj.f]
principe	[n] - prince [n]
principio	[n.m] - règle [n]
principio	[n] - principe [n]
priorità	[n.f.sp] - priorité [n]
privacy	[n] - caractère privé [n.m]
privare	[vblex] - priver [vblex]
privatizzazione	[n] - privatisation [n]
privilegiare	[vblex] - privilégier [vblex]
privilegio	[n] - privilège [n]
probabile	[adj] - probable [adj]
probabilità	[n.f.sp] - probabilité [n]
probabilmente	[adv] - probablement [adv]
problema	[n.m] - question [n]
problema	[n] - problème [n]
procedura	[n.f] - procédure [n.f]
processione	[n] - procession [n]
processo	[n] - processus [n.m.sp]
proclamare	[vblex] - proclamer [vblex]
procura	[n] - ministère public [n.m]
procurare	[vblex] - procurer [vblex]
prodotto	[n.m] - peinture [n]
prodotto	[n] - produit [n]
produrre	[vblex] - produire [vblex]
produttività	[n.f.sp] - productivité [n]
produttore	[adj] - producteur [adj]
produzione	[n] - production [n]
professionalmente	[adv] - professionnellement [adv]
professionista	[adj] - professionnel [adj.f]
professore	[n] - professeur [n.mf]
professore	[n] - professorat [n]
profeta	[n] - prophète [n.f]
profilattico	[n] - préservatif [n]
profilo	[n] - profil [n]
profondamente	[adv] - profondément [adv]
profondo	[adj] - profond [adj]
profumo	[n] - parfum [n]
progettare	[vblex] - projeter [vblex]
progetto	[n] - projet [n]
programma	[n] - programme [n]
programmare	[vblex] - programmer [vblex]
progressismo	[n] - progressisme [n]
progressivamente	[adv] - progressivement [adv]
proiettile	[n] - projectile [n]
proletario	[n] - prolétaire [n.mf]
proliferazione	[n] - prolifération [n]
promessa	[n] - promesse [n]
promotore	[adj] - promoteur [adj]
promozionale	[adj] - promotionnel [adj.f]
promozione	[n.f] - promotion [n.f]
promozione	[n] - promotion [n]
promuovere	[vblex] - promouvoir [vblex]
pronome	[n] - pronom [n]
pronuncia	[n] - prononciation [n]
pronunciare	[vblex] - prononcer [vblex]
propaganda	[n] - propagande [n]
propietà	[n] - domaine [n.m]
proporzionale	[adj] - proportionnel [adj.f]
proporzionalità	[n] - proportion [n]
proposizione	[n] - proposition [n]
propriamente	[adv] - proprement [adv]
proprietario	[adj] - propriétaire [adj.mf]
proprietario	[n] - propriétaire [n.mf]
proprio	[adj] - propre [adj.mf]
prosciutto	[n] - jambon [n]
proseguimento	[n.m] - continuation [n]
proseguire	[vblex] - poursuivre [vblex]
prosperità	[n.f.sp] - prospérité [n]
prospettiva	[n] - perspective [n]
prossimamente	[adv] - prochainement [adv]
prossimo	[adj] - prochain [adj]
prostituzione	[n] - prostitution [n]
prostituzione	[n] - prostituée [n]
proteina	[n] - protéine [n]
protesi	[n] - prothèse [n.f.ND]
protestantesimo	[n] - protestant [adj.f]
protestare	[vblex] - protester [vblex]
protezione	[n.f] - protection [n]
protocollo	[n] - protocole [n]
prototipo	[n] - prototype [n]
prova	[n] - essai [n.m]
provenire	[vblex] - conduite [n.f]
provincia	[n] - province [n]
provinciale	[adj] - provincial [adj.f]
provocare	[vblex] - provoquer [vblex]
provvedere	[vblex] - munir [vblex]
provvedimento	[n] - mandat [n.m]
provvisoriamente	[adv] - provisoirement [adv]
provvisorio	[adj] - provisoire [adj]
provvista	[n.f] - fourniture [n.f]
prudente	[adj] - prudent [adj.f]
prudenza	[n] - prudence [n]
prunus domestica	[n] - prune [n]
psichiatria	[n] - psychiatre [n]
psichiatria	[n] - psychiatrie [n]
psichico	[adj] - psychique [adj.mf]
psicologia	[n] - psychologie [n]
psicologia	[n] - psychologue [n.mf]
psicologicamente	[adv] - psychologiquement [adv]
psycho	[n] - psychose [n.f.ND]
pubblicamente	[adv] - publiquement [adv]
pubblicare	[vblex] - publier [vblex]
pubblici	[n] - audience [n]
pubblicitario	[adj] - publicitaire [adj.mf]
pubblicitario	[n] - publicitaire [adj.mf]
pubblicità	[n.f.sp] - publicité [n]
pubblicità	[n] - publiciste [n]
pubblico	[adj] - public [adj]
pubblico	[n] - public [adj]
pubblico ministero	[n] - ministère public [n.m]
pugno	[n] - poing [n]
pulizia	[n] - propreté [n]
pullman	[n] - bus [n.m.sp]
pulsare	[vblex] - appuyer sur [vblex]
punire	[vblex] - punir [vblex]
punizione	[n] - punition [n.f]
punta	[n] - pointe [n.f]
puntare	[vblex] - viser [vblex]
punto	[n] - maille [n.f]
punto	[n] - question [n.f]
punto interrogativo	[n] - interrogation [n]
puntuale	[adj] - ponctuel [adj.f]
puntualmente	[adv] - ponctuellement [adv]
pupilla	[n] - prunelle [n]
puramente	[adv] - purement [adv]
puramente	[adv] - simplement [adv]
puro	[adj] - pur [adj]
purtroppo	[adv] - malencontreusement [adv]
purtroppo	[adv] - malheureusement [adv]
può darsi	[adv] - peut être [adv]
può essere	[adv] - peut être [adv]
pylon	[n] - poteau [n]
quadro	[adj] - tableau [n]
quadro	[n] - tableau [n]
qualche	[det.ind.mf] - quelque [det.ind.mf]
qualcosa	[prn] - quelque chose [prn.tn.nt.sg]
qualcuno	[prn.tn.f] - quelqu'un [prn.tn.mf]
qualcuno	[prn.tn.m] - quelqu'un [prn.tn.mf]
quale	[adj] - comme [rel.adv]
quale	[det.dem] - comme [rel.adv]
quale	[prn.itg] - quel [prn.itg.f]
qualificazione	[n] - qualification [n]
qualità	[n.f.sp] - qualité [n]
qualità	[n] - qualité [n]
qualsiasi	[det.ind] - n'importe quel [det.ind.f]
qualsiasi	[prn.tn.mf.sp] - n'importe qui [prn.tn.mf.sp]
qualsivoglia	[prn.tn.mf.sp] - n'importe qui [prn.tn.mf.sp]
qualunque	[det.ind] - n'importe quel [det.ind.f]
qualunque	[prn.tn.mf.sp] - n'importe qui [prn.tn.mf.sp]
quando	[adv] - lorsque [cnjadv]
quando	[adv] - quand [adv]
quantitativo	[adj] - quantitatif [adj]
quantitativo	[n.m] - quantité [n]
quantità	[n.f.sp] - quantité [n]
quantità di moto	[n] - élan [n]
quantità vocalica	[n] - quantité [n]
quanto	[adj] - combien [prn.itg.mf.sp]
quanto	[adj] - combien [rel.adv]
quanto	[det.dem] - combien [rel.adv]
quanto	[prn.itg] - combien [prn.itg.mf.sp]
quanto	[prn.itg] - combien [rel.adv]
quaranta	[num] - quarante [num]
quaranta	[num] - quarante-six [num]
quarantacinque	[num] - quarante-cinq [num]
quarantadue	[num] - quarante-deux [num]
quarantanove	[num] - quarante-neuf [num]
quarantaquattro	[num] - quarante-quatre [num]
quarantasette	[num] - quarante-sept [num]
quarantatré	[num] - quarante-trois [num]
quarantena	[n] - quarantaine [n]
quarantotto	[num] - quarante-huit [num]
quarantuno	[num] - quarante et un [det]
quaresima	[n] - carême [n.m]
quattordicesimo	[adj] - quatorzième [adj.mf]
quattordici	[num] - quatorze [num]
quattro	[num] - quatre [num]
quattrocento	[num] - quatre cents [num]
quello	[det.dem.mf] - ce [det.dem.mf.pl]
quello	[det.dem] - ce [det.dem.mf.pl]
quello	[prn.tn.f] - ce [det.dem.mf.pl]
quello	[prn.tn.m] - ce [det.dem.mf.pl]
quello	[prn.tn.nt] - cela [prn]
quercus	[n] - chêne [n]
quercus ilex	[n] - yeuse [n]
questione	[n] - question [n]
questo	[det.dem.mf] - ce [det.dem.mf.pl]
questo	[det.dem] - ce [det.dem.mf.pl]
questo	[prn.tn.f] - ce [det.dem.mf.pl]
questo	[prn.tn.f] - celui-ci [prn]
questo	[prn.tn.f] - celui-là [prn]
questo	[prn.tn.m] - ce [det.dem.mf.pl]
questo	[prn.tn.m] - celui-ci [prn]
questo	[prn.tn.m] - celui-là [prn]
questo	[prn.tn.nt] - ce [prn]
qui	[adv] - ci [adv]
qui	[adv] - ici [adv]
quindi	[adv] - donc [cnjadv]
quindi	[adv] - par conséquent [cnjadv]
quindicesimo	[adj] - quinzième [adj.mf]
quotidianamente	[adv] - quotidiennement [adv]
quotidiano	[adj] - quotidien [adj]
quotidiano	[adv] - quotidiennement [adv]
quotidiano	[n] - quotidien [adj]
rabbia	[n] - colère [n]
raccontare	[vblex] - compter [vblex]
raccordare	[vblex] - joindre [vblex]
radar	[n] - radar [n]
raddrizzatore	[n] - rectification [n]
radiante	[adj] - radieux [adj.m.sp]
radiazione	[n] - radiation [n]
radicale	[adj] - radical [adj.f]
radicalmente	[adv] - radicalement [adv]
radice	[n] - racine [n]
radio	[n] - radio [n]
radiografia convenzionale	[n] - radiographie [n]
radura	[adv] - clair [adj]
raffineria	[n] - raffinerie [n]
raffreddore	[n] - rhume [n]
raffronto	[n.m] - confrontation [n]
ragazzo	[n] - enfant [n.mf]
raggio	[n] - portée [n.f]
ragionamento	[n] - raisonnement [n]
ragionevole	[adj] - raisonnable [adj]
ragionevolmente	[adv] - raisonnablement [adv]
ragno	[n] - araignée [n]
rally	[n] - rally [n]
rame	[n] - cuivre [n]
ramo	[n] - bouquet [n.m]
rapidamente	[adv] - promptement [adv]
rapidamente	[adv] - rapidement [adv]
rapido	[adj] - rapide [adj.mf]
rappresentante	[n.mf] - représentant [n.f]
rappresentare	[vblex] - représenter [vblex]
raptore	[n] - ravisseur [n]
raramente	[adv] - rarement [adv]
raro	[adj] - rare [adj.mf]
ratificare	[vblex] - ratifier [vblex]
ravvicinamento	[n.m] - approximation [n]
razionale	[adj] - rationnel [adj.f]
razza	[n] - race [n]
razziale	[adj] - racial [adj.f]
razzismo	[n] - racisme [n]
razzo	[n] - roquette [n.f]
re	[n] - roi [n]
reagire	[vblex] - réagir [vblex]
reale	[adj] - royal [adj.f]
realismo	[n] - réalisme [n]
realizzare	[vblex] - réaliser [vblex]
realmente	[adv] - réellement [adv]
realtà	[n.f.sp] - réalité [n]
reattore	[n] - réacteur [n]
recentemente	[adv] - naguère [adv]
recepimento	[n.m] - transposition [n]
recessione	[n] - abaissement [n.m]
recessione	[n] - récession [n]
recinto	[n] - enceinte [n.f]
reciprocamente	[adv] - l'un de l'autre [adv]
reclamare	[vblex] - réclamer [vblex]
reclamo	[n.m] - protestation [n]
recuperare	[vblex] - regagner [vblex]
recupero	[n.m] - recette [n]
recupero	[n.m] - relance [n]
reddito	[n] - dépôt [n]
reddito	[n] - rente [n]
referendum	[n] - référendum [n]
referente	[adj] - référent [n]
reforestazione	[n] - reforestation [n]
refrigerazione	[n] - réfrigération [n]
regalare	[vblex] - offrir [vblex]
regata	[n] - régate [n]
regime	[n.m] - sort [n.m]
regime	[n] - régime [n]
regionale	[adj] - régional [adj.f]
regione	[n] - région [n]
registrare	[vblex] - enregistrer [vblex]
registro	[n] - registre [n]
regnare	[vblex] - régner [vblex]
regola	[n] - règle [n]
regolamentare	[vblex] - réglementer [vblex]
regolamento	[n.m] - regulation [n]
regolare	[adj] - régulier [adj.f]
regolare	[vblex] - régulier [adj.f]
regolarmente	[adv] - régulièrement [adv]
reinserimento	[n.m] - réinsertion [n]
reinvestire	[vblex] - réinvestir [vblex]
reiterato	[adj] - réitéré [adj]
relativamente	[adv] - relativement [adv]
relativo	[adj] - relatif [adj]
relazione	[n.f] - rapport [n]
relazione	[n] - relation [n]
religione	[n] - religion [n]
religioso	[adv] - religieusement [adv]
reliquia	[n] - relique [n]
remo	[n] - aviron [n]
rene	[n] - rein [n]
repeater	[n] - répéteur [n]
replicare	[vblex] - riposter [vblex]
repressione	[n] - répression [n]
reprimere	[vblex] - réprimer [vblex]
reptilia	[n] - reptile [n]
repubblica	[n] - république [n]
repubblica democratica del congo	[n] - congolais [adj.f]
repubblica dominicana	[n] - dominicain [adj]
repubblicano	[adj] - républicain [adj]
reputazione	[n.f] - prestige [n]
residenziale	[adj] - résidentiel [adj.f]
residuale	[adj] - résiduel [adj.f]
resistente	[adj] - résistant [adj.f]
resistenza	[n] - résistance [n]
respirare	[vblex] - respirer [vblex]
respirazione	[n] - respiration [n]
responsabile	[adj] - responsable [adj]
responsabile	[n.mf] - chef [n.mf]
responsabilità	[n.f.sp] - responsabilité [n]
restare	[vblex] - rester [vblex]
restare	[vblex] - soustraire [vblex]
restaurare	[vblex] - restaurer [vblex]
restituire	[vblex] - restituer [vblex]
resurrezione	[n] - résurrection [n]
retablo	[n] - retable [n]
retina	[n] - rétine [n]
retorica	[n] - rhétorique [n]
retrocedere	[vblex] - reculer [vblex]
retrospettivo	[adj] - rétrospectif [adj]
retto	[n] - droit [adv]
reversibile	[adj] - réversible [adj]
revisionare	[vblex] - réviser [vblex]
riaprire	[vblex] - rouvrir [vblex]
ribelle	[adj] - rebelle [adj]
ricchezza	[n] - richesse [n]
ricco	[adj] - riche [adj.mf]
ricco	[adv] - richement [adv]
ricerca	[n] - investigation [n]
ricerca scientifica	[n] - chercheur [n]
ricerca scientifica	[n] - investigation [n]
ricercare	[vblex] - enquêter [vblex]
ricercatore	[n] - chercheur [n]
riciclaggio dei rifiuti	[n] - recyclage [n]
ricompensare	[vblex] - décerner un prix [vblex]
ricompensare	[vblex] - récompenser [vblex]
ricongiungimento	[n.m] - regroupement [n.m]
riconoscere	[vblex] - reconnaître [vblex]
ricordare	[vblex] - convenir [vblex]
ricordare	[vblex] - rappeler [vblex]
ricorrere	[vblex] - faire appel [vblex]
ricorrere	[vblex] - parcourir [vblex]
ridefinire	[vblex] - redéfinir [vblex]
ridicolo	[adj] - ridicule [adj.mf]
ridondanza	[n] - redondance [n]
riducente	[n] - réducteur [adj]
riduzione	[n] - reduction [n]
riempire	[vblex] - remplir [vblex]
rifiuti	[n] - déchet [n.m.pl]
rifiuti	[n] - ordures [n.f.pl]
rifiuto	[n.m] - dénégation [n]
riflessione	[n] - réflexion [n]
rifornimento	[n] - ravitaillement [n]
rifornire	[vblex] - approvisionner [vblex]
rifugio alpino	[n] - refuge [n]
rigenerazione	[n] - régénération [n]
rigore	[n] - rigueur [n.f]
rigorosamente	[adv] - strictement [adv]
rigoroso	[adj] - rigoureux [adj.f]
rilancio	[n.m] - revitalisation [n]
rilascio	[n.m] - expedition [n]
rilevare	[vblex] - prendre la relève de [vblex]
rilevazione	[n] - dépistage [n.m]
rilievo	[n] - relais [n.m.sp]
rimanere	[vblex] - rester [vblex]
rimborso	[n.m] - renvoi [n.m]
rimborso	[n] - remboursement [n]
rimpatriare	[vblex] - rapatrier [vblex]
rimuovere	[vblex] - brasser [vblex]
rinnovabile	[adj] - renouvelable [adj]
rinnovare	[vblex] - renouveler [vblex]
rinnovo	[n.m] - renouvellement [n.m]
riorganizzare	[vblex] - réorganiser [vblex]
riparare	[vblex] - réparer [vblex]
riparo	[n] - abri [n]
ripetere	[vblex] - répéter [vblex]
ripetizione	[n] - répétition [n]
ripetutamente	[adv] - à plusieurs reprises [adv]
ripristino	[n.m] - relance [n]
riproduzione	[n] - reproduction [n]
ripugnanza	[n] - animosité [n]
ripugnanza	[n] - répugnance [n]
riscaldamento	[n] - échauffement [n]
riscaldare	[vblex] - échauffer [vblex]
rischio	[n] - risque [n]
riscossione	[n] - encaissement [n]
riscuotere	[vblex] - toucher [vblex]
riservare	[vblex] - réserver [vblex]
riso	[n] - rire [n.m]
riso	[n] - riz [n.m.sp]
riso	[n] - sourire [n.m]
risoluzione	[n] - résolution [n]
risolvere	[vblex] - résoudre [vblex]
risorsa	[n.f] - recours [n.m.sp]
risparmio	[n] - épargne [n]
rispettivamente	[adv] - respectivement [adv]
rispetto a	[adv] - face à [pr]
rispondere	[vblex] - répondre [vblex]
risposta	[n.f] - avis [n.m.sp]
risposta	[n] - réponse [n]
ristorante	[n] - restaurant [n]
ristrutturazione	[n] - redéploiement [n.m]
risultare	[vblex] - résulter [vblex]
risultato	[n] - résultat [n]
ritmo	[n] - rythme [n]
rito	[n] - rite [n]
ritocco	[n] - retouche [n.f]
ritornare	[vblex] - retourner [vblex]
ritratto	[n] - portrait [n]
rituale	[adj] - rituel [adj.f]
riunione	[n] - réunion [n]
riunire	[vblex] - rallier [vblex]
riuscire	[vblex] - remporter [vblex]
rivelare	[vblex] - révéler [vblex]
rivelatore	[n] - détecteur [n]
rivelazione	[n] - révélation [n]
rivendicare	[vblex] - revendiquer [vblex]
rivendicazione	[n] - revendication [n]
rivolta	[n] - insurrection [n]
rivolta	[n] - rébellion [n]
rivoltella	[n] - revolver [n]
rivoluzionario	[adj] - révolutionnaire [adj.mf]
rivoluzione	[n] - revolution [n]
robot	[n] - robot [n]
roccia	[n] - roche [n]
rock and roll	[n] - rock [n]
rom	[n] - gitan [n]
romanticismo	[n] - romantisme [n]
romanziere	[n] - romancier [n.f]
romanzo	[n] - roman [n.m]
romanzo picaresco	[n] - coquin [adj]
romero	[n] - romarin [n]
rompere	[vblex] - briser [vblex]
rosa	[n] - rose [adj]
rosario	[n] - rosaire [n]
rosso	[adj] - rouge [adj.mf]
rosso	[n] - rouge [adj.mf]
rotaia	[n.f] - rail [n]
rotatoria	[n] - rotonde [n]
rotatoria	[n] - tonnelle [n]
rotazione	[n] - roulement [n.m]
rotazione	[n] - virement [n]
rotondo	[adj] - rond [adj]
rotta	[n.f] - rhumb [n]
rotta	[n] - route [n]
roulette	[n] - roulette [n]
rubare	[vblex] - voler [vblex]
rubinetto	[n] - robinet [n]
rumeno	[adj] - roumain [adj]
rumoroso	[adj] - ronflant [adj]
rumors	[n] - rumeur [n.f]
ruota	[n] - roue [n]
rurale	[adj] - rural [adj.f]
ruscello	[n] - ruisseau [n]
russo	[adj] - russe [adj.mf]
s	[n] - s [n.m]
sabato	[n] - samedi [n]
sabbia	[n] - sable [n.m]
sabotaggio	[n] - sabotage [n]
sacramento	[n] - sacrement [n]
sacrificare	[vblex] - sacrifier [vblex]
sacrificio	[n] - sacrifice [n]
saggezza	[n] - savant [adj]
saggio	[n] - essai [n]
sagrato	[adj] - sacré [adj]
salariale	[adj] - salarial [adj.f]
salario	[n] - rémunération [n]
salario	[n] - salaire [n]
saldare	[vblex] - solder [vblex]
saldo	[n] - solde [n]
sale	[n.m] - sel [n.m]
sale	[n] - sel [n.m]
salina	[n] - mine de sel [n]
salino	[adj] - salin [adj]
saliva	[n] - salive [n]
salivare	[vblex] - saliver [vblex]
salsa	[n] - sauce [n]
saltare	[vblex] - sauter [vblex]
salto	[n] - saut [n]
salute	[n] - santé [n]
salvadanaio	[n] - tirelire [n.m]
salvaguardare	[vblex] - sauvegarder [vblex]
salvare	[vblex] - sauver [vblex]
sangue	[n.m] - sang [n.m]
sano	[adj] - sain [adj]
santo	[adj] - saint [adj]
santo	[n] - saint [adj]
sanzionare	[vblex] - sanctionner [vblex]
sanzione	[n] - autorisation [n]
sanzione	[n] - sanction [n]
sapere	[vblex] - savoir [n]
sapone	[n] - savon [n]
sarcasmo	[n] - sarcasme [n]
sardina	[n] - sardine [n]
sasso	[n] - caillou [n.m]
satellite	[n] - satellite [n]
satira	[n] - satire [n]
saturare	[vblex] - saturer [vblex]
sbarra	[n] - barre [n]
sbocco	[n] - embouchure [n]
scacchi	[n] - échecs [n.m.pl]
scala	[n] - escalier [n.m]
scala	[n] - échelle [n.f]
scam	[n] - escroquerie [n]
scam	[n] - fraude [n]
scam	[n] - tromperie [n.f]
scandalo	[n] - scandale [n]
scanner	[n] - scanner [n]
scappare	[vblex] - fuir [vblex]
scappare	[vblex] - échapper [vblex]
scarpa	[n.f] - chaussure [n.f]
scarpa	[n] - chaussure [n.f]
scarsità	[n.f.sp] - pénurie [n]
scatola	[n] - boîte [n]
scavare	[vblex] - terrasser [vblex]
scavo	[n] - excavation [n]
scegliere	[vblex] - choisir [vblex]
scena	[n] - scène [n]
scenario	[n] - palestre [n]
scendere	[vblex] - abaisser [vblex]
sceneggiatura	[n] - scénario [n]
scheletro	[n] - squelette [n]
schema	[n] - schéma [n]
schermo	[n] - moniteur [n]
schermo	[n] - écran [n.m]
scherzo	[n] - plaisanterie [n]
schiavismo	[n] - esclave [n.mf]
schiavo	[n] - esclave [n.mf]
schiena	[n] - dos [n.m.sp]
schifo	[adj] - dégoût [n]
schifo	[n] - dégoût [n]
sci	[n] - ski [n]
sciabola	[n] - sabre [n]
scienza	[n] - science [n]
scienziato	[n] - scientifique [adj.mf]
scimmia	[n] - singe [n.mf]
sciopero	[n.m] - grève [n]
sciopero	[n] - grève [n]
scivolare	[vblex] - glisser [vblex]
scodella	[n] - messe [n]
scogliera	[n.f] - récif [n]
scogliera	[n] - récif [n]
scolastico	[adj] - scolaire [adj]
scommessa	[n] - pari [n.m]
scommettere	[vblex] - miser [vblex]
scomunica	[n] - excommunication [n]
sconfiggere	[vblex] - abattre [vblex]
sconfitta	[n] - défaite [n]
scontento	[adj] - mécontent [adj]
scontro	[n] - affrontement [n]
scontro	[n] - choc [n]
scopo	[n] - fin [n.f]
scopo	[n] - objectif [adj]
scorta	[n.f] - stock [n]
scossa	[n.f] - sursaut [n]
scozzese	[adj] - écossais [adj.f]
scrivere	[vblex] - écrire [vblex]
scrofa	[n] - cochon [n.f]
scudo	[n] - bouclier [n]
scultore	[n] - sculpteur [n]
scultura	[n] - sculpteur [n]
scultura	[n] - sculpture [n]
scuola	[n] - collège [n]
scuola	[n] - scolaire [adj]
scuola	[n] - école [n]
scure	[n] - hache [n]
scuro	[adj] - obscur [adj]
scusare	[vblex] - excuser [vblex]
se	[cnjadv] - si [cnjadv]
seccare	[vblex] - sécher [vblex]
seco	[prn] - avec soi [prn.tn]
secolo	[n] - siècle [n]
secondo	[n] - deuxième [adj.mf]
secondo	[pr] - d'après [cnjadv]
sedia	[n] - chaise [n]
sedici	[num] - seize [num]
segmento	[n] - segment [n]
segnalare	[vblex] - flécher [vblex]
segnale	[n.m] - signal [n.m]
segnale elettrico	[n] - signal [n.m]
segno	[n] - signe [n]
segretamente	[adv] - en secret [adv]
segretario	[n] - secrétaire [n.mf]
segreto	[adj] - secret [adj]
seguire	[vblex] - suivre [vblex]
sei	[num] - six [adj]
semaforo	[n] - sémaphore [n]
semantica	[n] - sémantique [n]
semantico	[adj] - sémantique [adj.mf]
sembrare	[n] - avis [n.m.sp]
sembrare	[vblex] - avis [n.m.sp]
seme	[n.m] - fève [n]
seme	[n] - pépite [n]
seminare	[vblex] - semer [vblex]
seminario	[n] - séminaire [n]
semplice	[adj] - simple [adj]
semplicemente	[adv] - bonnement [adv]
semplicemente	[adv] - simplement [adv]
sempre	[adv] - toujours [adv]
senato	[n] - sénat [n]
senato	[n] - sénateur [n.m]
seno	[n] - sein [n]
sensazione	[n] - sensation [n]
sensibile	[adj] - sensible [adj]
sensibilizzare	[vblex] - sensibiliser [vblex]
sensibilmente	[adv] - sensiblement [adv]
senso	[n] - sens [n.m.sp]
sensore	[n] - capteur [n]
sensoriale	[adj] - sensoriel [adj.f]
sensual	[adj] - sensuel [adj.f]
sentenza	[n] - jugement [n]
sentenza	[n] - sentence [n]
sentimentale	[adj] - sentimental [adj.f]
sentimento	[n] - sentiment [n]
sentire	[vblex] - entendre [vblex]
senza	[pr] - sans [pr]
separare	[vblex] - séparer [vblex]
sequel	[n] - séquelle [n]
sereno	[adj] - serein [adj]
sergente	[n] - sergent [n.m]
seriamente	[adv] - sérieusement [adv]
serpentes	[n] - serpent [n.m]
serra	[n] - serre [n.f]
serrare	[vblex] - scier [vblex]
serratura	[n] - serrure [n]
server	[n] - serviteur [n]
servitù	[n] - servitude [n]
servizio	[n] - service [n]
sessantesimo	[adj] - soixantième [adj.mf]
sessismo	[n] - sexisme [n]
sesso	[n] - sexe [n]
sessuale	[adj] - sexuel [adj.f]
sessualmente	[adv] - sexuellement [adv]
sesto	[adj] - sixième [adj.mf]
sesto	[n] - sixième [adj.mf]
seta	[n] - soie [n]
setta	[n] - secte [n]
sette	[num] - sept [num]
settembre	[n.m.pl] - septembre [n]
settembre	[n.m.sp] - septembre [n]
settembre	[n] - septembre [n]
settimana	[n] - semaine [n]
settimanale	[adj] - hebdomadaire [adj]
settimanalmente	[adv] - chaque semaine [adv]
settimo	[adj] - septième [adj.mf]
sezione	[n] - section [n]
sfavorevole	[adj] - défavorable [adj]
sfera	[n] - aire [n]
sfera	[n] - boule [n]
sfera	[n] - cadran [n.m]
sfera	[n] - sable [n.m]
sfida	[n.f] - défi [n]
sfilata	[n.f] - intestin [n]
sfortunatamente	[adv] - malencontreusement [adv]
sforzo	[n] - effort [n]
sfruttare	[vblex] - exploiter [vblex]
sfumatura	[n.f] - nuance [n.f]
sgradevolmente	[adv] - désagréablement [adv]
show	[n] - show [n]
si	[prn.pro] - on [prn.enc.ref.p3.mf.sp]
sicché	[cnjsub] - donc [cnjadv]
siccità	[n] - sécheresse [n]
siccome	[cnjadv] - donc [cnjadv]
sicuramente	[adv] - certainement [adv]
sicurezza	[n] - sécurité [n]
siepe	[n.f] - haie [n.f]
sigaretta	[n] - cigare [n]
sigaretta	[n] - cigarette [n.f]
sigaro	[n] - cigare [n]
siglare	[vblex] - parapher [vblex]
significare	[vblex] - signifier [vblex]
significativo	[adj] - significatif [adj]
significato	[n.m] - signification [n]
signore	[n] - cavalier [n]
signore	[n] - dame [n.f]
silenzioso	[adj] - silencieux [adj.f]
silicio	[n] - silicium [n]
simbolismo	[n] - symbolisme [n]
simbolo	[n] - symbole [n]
simile	[adj] - semblable [adj.mf]
simile	[adj] - similaire [adj]
simile	[n] - semblable [adj.mf]
simulare	[vblex] - simuler [vblex]
simulazione	[n] - simulateur [n]
simulazione	[n] - simulation [n]
simultaneamente	[adv] - simultanément [adv]
simultaneamente	[adv] - à la fois [adv]
sinceramente	[adv] - sincèrement [adv]
sincero	[adj] - sincère [adj.mf]
sindacale	[adj] - syndical [adj.f]
sindacato	[n] - syndicat [n]
sindaco	[n] - maire [n]
sindrome	[n.f] - syndrome [n]
sindrome	[n] - syndrome [n]
singolare	[adj] - singulier [adj.f]
singolo	[adv] - seul [adj]
sinistra	[n] - gauche [n]
sinistrato	[adj] - sinistré [adj]
sinistro	[adj] - sinistre [adj.mf]
sinistro	[n] - accident [n]
sipario	[n] - rideau [n.m]
siracide	[n] - ecclésiastique [adj.mf]
sirena	[n] - sirène [n]
siringa	[n] - seringat [n.m]
sistema	[n] - système [n]
sistematicamente	[adv] - systématiquement [adv]
sistematico	[adj] - systématique [adj.mf]
situare	[vblex] - situer [vblex]
sleale	[adj] - déloyal [adj.f]
smentire	[vblex] - démentir [vblex]
smisurato	[adj] - démesuré [adj]
soccorrere	[vblex] - secourir [vblex]
sociale	[adj] - social [adj.f]
socialismo	[n] - socialisme [n]
socialista	[n] - socialiste [adj]
socializzazione	[n] - socialisation [n]
socialmente	[adv] - socialement [adv]
società	[n.f.sp] - société [n]
sociologia	[n] - sociologue [n.mf]
sociologico	[adj] - sociologique [adj.mf]
soddisfare	[vblex] - satisfaire [vblex]
sodio	[n] - sodium [n]
soffiare	[vblex] - souffler [vblex]
soffrire	[vblex] - souffrir [vblex]
software	[n] - application [n]
software	[n] - logiciel [n]
sofà	[n.m.sp] - sofa [n]
soggettivo	[adj] - subjectif [adj]
soglia	[n.f] - seuil [n]
sognare	[vblex] - rêver [vblex]
sogno	[n] - rêve [n]
soia	[n] - soja [n]
solamente	[adv] - seulement [adv]
solamente	[adv] - simplement [adv]
solanum lycopersicum	[n] - tomate [n.f]
solanum melongena	[n] - aubergine [n]
solanum tuberosum	[n] - pomme de terre [n]
solare	[adj] - solaire [adj]
soldato	[n] - soldat [n]
sole	[n] - soleil [n]
solenne	[adj] - solennel [adj.f]
solere	[vblex] - avoir l'habitude de [vblex]
solfeggio	[n] - solfège [n]
solitario	[adj] - solitaire [adj.mf]
sollecitare	[vblex] - solliciter [vblex]
solo	[adj] - seul [adj]
solo	[adv] - seulement [adv]
soltanto	[adv] - seulement [adv]
soltanto	[adv] - simplement [adv]
soluzione	[n] - dissolution [n]
solvente	[adj] - solvable [adj]
somaro	[n] - âne [n.f]
somaro	[n] - âne [n]
sommamente	[adv] - extrêmement [adv]
sommario	[adj] - sommaire [n]
sommario	[n] - sommaire [n]
son	[n] - son [n]
sondaggio	[n] - sondage [n]
sonno	[n] - rêve [n]
sopportare	[vblex] - endurer [vblex]
sopra	[adv] - en dessus [adv]
sopra	[pr] - enveloppe [n.f]
sopracciglio	[n] - arche [n.f]
sopracciglio	[n] - sourcil [n.m]
soprano	[n] - soprano [n]
soprattassa	[n.f] - surcharge [n.f]
soprattutto	[adv] - notamment [adv]
sopravvivenza	[n] - survivance [n]
sorgere	[vblex] - dresser [vblex]
sorgere	[vblex] - surgir [vblex]
sorprendentemente	[adv] - surprenantement [adv]
sorprendere	[vblex] - surprendre [vblex]
sorpresa	[n] - surprise [n]
sorvegliante	[n.m] - surveillant [n.f]
sospendere	[vblex] - suspendre [vblex]
sospensione	[n] - suspension [n]
sospettoso	[adj] - suspect [adj]
sostantivo	[n] - substantif [adj]
sostanza	[n.f] - facteur [n]
sostanzialmente	[adv] - basiquement [adv]
sostenere	[vblex] - appuyer [vblex]
sostenere	[vblex] - soutenir [vblex]
sotterraneo	[adj] - souterrain [adj]
sottile	[adj] - subtil [adj.f]
sotto	[adv] - dessous [adv]
sotto	[pr] - bas [adj.f]
sottomarino	[n] - sous-marin [adj]
sottosuolo	[n] - sous-sol [n]
sottovalutare	[vblex] - sous-estimer [vblex]
sottrarre	[vblex] - soustraire [vblex]
sottrazione	[n] - différence [n]
sottrazione	[n] - soustraction [n]
sovranità	[n] - souveraineté [n]
sovrano	[adj] - souverain [adj]
spada	[n] - épée [n]
spagnolo	[n] - espagnol [adj]
spalla	[n] - épaule [n.f]
spaziale	[adj] - spatial [adj.f]
spazio	[n] - espace [n]
spazzatura	[n] - ordures [n.f.pl]
spazzola	[n] - brosse [n.f]
specchio	[n] - miroir [n]
speciale	[adj] - spécial [adj.f]
specializzazione	[n] - spécialisation [n]
specialmente	[adv] - spécialement [adv]
specie	[n] - espèce [n]
specificamente	[adv] - spécifiquement [adv]
specifico	[adj] - spécifique [adj.mf]
speranza	[n] - espoir [n.m]
sperare	[vblex] - attendre [vblex]
sperimentale	[adj] - expérimental [adj.f]
spermatozoo	[n] - spermatozoïde [n]
sperpero	[n] - usure [n.f]
spesa	[n.f] - dépense [n.f]
spesso	[adv] - souvent [adv]
spettacolare	[adj] - spectaculaire [adj]
spettacolo	[n] - spectacle [n]
spettatore	[n] - spectateur [n]
spettro	[n] - spectre [n]
spia	[n] - espion [n.f]
spiaggia	[n] - plage [n]
spiare	[vblex] - épier [vblex]
spingere	[vblex] - pousser [vblex]
spionaggio	[n] - espion [n.f]
spionaggio	[n] - espionnage [n]
spirito	[n] - esprit [n]
spirituale	[adj] - spirituel [adj.f]
spontaneo	[adj] - spontané [adj]
sport	[n] - sport [n]
sport	[n] - sportif [adj.f]
sportivo	[adj] - sportif [adj]
spreco	[n] - gaspillage [n]
sprint nextel	[n] - sprint [n]
spunto	[n] - inspiration [n]
squadra	[n] - équipe [n.f]
squalo	[n] - requin [n]
squilibrato	[adj] - balourd [adj]
squisitamente	[adv] - exquisément [adv]
stabile	[adj] - stable [adj]
stabilimento	[n] - fabrique [n]
stabilire	[vblex] - établir [vblex]
stabilità	[n.f.sp] - stabilité [n]
stadio	[n] - court [n]
stadio	[n] - stade [n]
stagione	[n] - gare [n]
stagioni	[n] - saison [n]
stalla	[n] - étable [n.f]
stampa	[n] - imprimerie [n]
stampante	[n] - imprimante [n]
stampo	[n] - moule [n]
standard	[adj] - standard [adj]
standard	[n] - standard [adj]
stanza	[n.f] - caméra [n]
stanza	[n] - chambre [n]
stanza	[n] - quatrième [adj.mf]
stare	[vblex] - être [vblex]
statale	[adj] - de l'état [adj.mf.sp]
stati	[n] - etat [n]
statisticamente	[adv] - statistiquement [adv]
statistico	[adj] - statistique [adj.mf]
stato	[n] - etat [n]
stato	[n] - nation [n]
statua	[n] - statue [n]
statunitense	[adj] - américain [adj.f]
stazione di servizio	[n] - station-service [n]
stele	[n] - sillage [n.m]
stella	[n] - astre [n]
stella	[n] - vedette [n]
sterile	[adj] - stérile [adj]
sterilità	[n.f.sp] - infertilité [n]
stile	[n] - style [n]
stima	[n] - estimation [n]
stimolo	[n.m] - sensation [n]
stomaco	[n] - estomac [n]
stoppino	[n] - mèche [n]
storia	[n] - histoire [n]
storia	[n] - narration [n]
storicamente	[adv] - historiquement [adv]
storico	[adj] - historique [adj.mf]
strada	[n] - route [n]
strada	[n] - rue [n.f]
strada	[n] - voie [n]
straniero	[adj] - étranger [adj]
straniero	[n] - étranger [adj]
strano	[adj] - bizarre [adj.mf]
straordinario	[adj] - extraordinaire [adj.mf]
strategia	[n] - stratégie [n]
strategico	[adj] - stratégique [adj.mf]
strato	[n.m] - cape [n]
stress	[n] - stress [n.m.sp]
strettamente	[adv] - étroitement [adv]
stretto	[adj] - étroit [adj]
stringa	[n] - chaîne [n]
strofinare	[vblex] - frotter [vblex]
strumentale	[adj] - instrumental [adj.f]
strumento	[n] - instrument [n]
struttura	[n] - structure [n]
strutturale	[adj] - structural [adj.f]
studente	[n.f] - étudiant [n.f]
studente	[n.GD] - étudiant [n.f]
studente	[n.m] - étudiant [n.f]
studiare	[vblex] - étudier [vblex]
studio	[n] - étude [n.f]
stupendamente	[adv] - excellemment [adv]
stupido	[adj] - stupide [adj.mf]
stupore	[n] - stupeur [n]
stupro	[n] - violation [n]
stuzzicare	[vblex] - provoquer [vblex]
su grande scala	[adv] - à grande échelle [adv]
su scala	[adv] - à échelle [adv]
subire	[vblex] - monter [vblex]
subnormale	[adj] - idiot [adj.GD]
successivamente	[adv] - après [adv]
successivamente	[adv] - postérieurement [adv]
successivamente	[adv] - successivement [adv]
successo	[n] - succès [n.m.sp]
successore	[n] - successeur [n]
succo	[n] - jus [n]
sud	[n] - sud [n]
sudare	[vblex] - suer [vblex]
sufficientemente	[adv] - suffisamment [adv]
suffragio	[n.m] - suffrage [n]
suggerimento	[n.m] - suggestion [n]
suicidio	[n] - suicide [n]
suicidio	[n] - suicidé [n.f]
suo	[adj.pos] - à il [adj.pos]
suo	[det.pos.f] - à il [adj.pos]
suo	[det.pos.m] - à il [adj.pos]
suolo	[n] - sol [n]
suonare	[vblex] - sonner [vblex]
suonare	[vblex] - toucher [vblex]
suono	[n] - son [n]
superamento	[n.m] - dépassement [n.m]
superare	[vblex] - franchir [vblex]
superficiale	[adj] - superficiel [adj.f]
superficialmente	[adv] - légèrement [adv]
superficie	[n] - surface [n]
superiore	[adj] - supérieur [adj.f]
supermercato	[n] - supermarché [n]
superstrada	[n] - route à quatre voies [n]
supplementare	[adj] - additionnel [adj.f]
supplente	[n.m] - lieutenant [n.f]
supplente	[n.m] - suppléant [adj.f]
supplicare	[vblex] - supplier [vblex]
supposizione	[n] - supposition [n]
suppostamente	[adv] - soi-disant [adv]
supremo	[adj] - suprême [adj.mf]
surplus	[n] - excédent [n]
surrealismo	[n] - surréalisme [n]
sus domesticus	[n] - cochon [adj]
suscettibile	[adj] - susceptible [adj]
suscitare	[vblex] - susciter [vblex]
sussidio	[n] - subside [n]
sutura	[n] - suture [n]
svedese	[adj] - suédois [adj.f]
sviluppare	[vblex] - révéler [vblex]
sviluppo sostenibile	[n] - durabilité [n]
svizzera	[n] - suisse [adj.mf]
sè	[prn.tn] - oui [adv]
sé	[prn.tn] - oui [adv]
sì	[adv] - oui [adv]
t	[n] - t [n.m]
t-shirt	[n] - chemisette [n]
tabacco	[n] - tabac [n]
tabagismo	[n] - tabagisme [n]
tabella	[n.f] - tableau [n]
tabla	[n] - table [n]
tabù	[n] - tabou [adj.f]
taco	[n] - taquet [n]
tagliafuoco	[n] - coupe-feu [n.m.sp]
tagliare	[vblex] - couper [vblex]
taglio	[n] - cour [n.f]
tailandese	[adj] - thaïlandais [adj.f]
tale	[det] - tel [adj.f]
tale	[prn] - tel [adj.f]
talento	[n] - talent [n]
talisman	[n] - talisman [n]
tallone	[n] - talon [n]
taluno	[det.ind] - vrai [adv]
tamburo	[n] - tambour [n]
tamponamento	[n.m] - rideau [n.m]
tandem	[n] - tandem [n]
tango argentino	[n] - tango [n]
tanto	[adv] - tellement [adj.mf.sp]
tappa	[n] - étape [n]
tappeto	[n.m] - tapis [n.m.sp]
tappeto	[n] - moquette [n]
tappeto	[n] - tapis [n.m.sp]
tara	[n] - tare [n]
tardare	[vblex] - tarder [vblex]
tardio	[adj] - tardif [adj]
tardivo	[adj] - tardif [adj]
tasca	[n] - poche [n.f]
tassa	[n] - impôt [n]
tastiera	[n.f] - clavier [n]
tastiera	[n] - clavier [n]
tattica	[n] - tactique [adj.mf]
tattica	[n] - tactique [n]
tavolo	[n] - table [n]
taxi	[n] - chauffeur de taxi [n.m]
taxi	[n] - taxi [n]
tazza	[n] - coupe [n]
te	[prn.tn] - tu [prn]
teatrale	[adj] - théâtral [adj.f]
teatro	[n] - théâtre [n]
tecnicamente	[adv] - techniquement [adv]
tecnico	[adj] - technique [adj.mf]
tecnologia	[n] - technologie [n]
tecnologico	[adj] - technologique [adj.mf]
teco	[prn] - avec toi [prn.tn]
tedesca	[n] - allemand [adj]
tedesco	[adj] - allemand [adj]
tedesco	[n] - allemand [adj]
teia	[n] - tante [n]
telecomunicazioni	[n] - télécommunication [n]
telefax	[n] - fax [n]
telefonare	[vblex] - téléphoner [vblex]
telefonicamente	[adv] - téléphoniquement [adv]
telefonico	[adj] - théléphonique [adj.mf]
telefono	[n] - téléphone [n]
telefono	[n] - téléphonie [n]
telescopio	[n] - télescope [n]
teletext	[n] - télétexte [n]
televisione	[n] - télé [n]
televisione	[n] - téléviseur [n]
tema natale	[n] - horoscope [n]
temere	[vblex] - craindre [vblex]
temibile	[adj] - redoutable [adj]
temperatura	[n] - température [n]
tempi supplementari	[n] - sursis [n.m]
tempio	[n] - temple [n]
tempo	[n] - temps [n.m.sp]
temporale	[adj] - temporel [adj.f]
temporale	[n] - tempête [n]
temporalmente	[adv] - temporellement [adv]
tenacità	[n.f.sp] - ténacité [n]
tenda veneziana	[n] - persienne [n]
tendenza	[n] - tendance [n]
tenente	[n] - lieutenant [n.f]
tenere	[vblex] - avoir [vblex]
tennis	[n] - joueur de tennis [n.f]
tennis	[n] - tennis [n]
tensione	[n] - tension [n]
tensione elettrica	[n] - voltage [n]
tentare	[vblex] - essayer [vblex]
tentare	[vblex] - tenter [vblex]
tentativo	[n.m] - tentative [n]
tenuta	[n] - administration [n]
tenuta	[n] - ferme [n]
tenuta	[n] - trésor [n.m]
teologia	[n] - théologie [n]
teoria	[n] - théorie [n]
teoricamente	[adv] - théoriquement [adv]
terapeutico	[adj] - thérapeutique [adj.mf]
terapia	[n] - thérapie [n]
tercio	[n] - tiers [n.m.sp]
terminale	[adj] - terminal [adj.f]
terminale	[n] - terminal [adj.f]
terminare	[vblex] - achever [vblex]
terminare	[vblex] - terminer [vblex]
terminologia	[n] - terminologie [n]
termometro	[n] - thermomètre [n]
terra	[n] - terroir [n.m]
terra di lavoro	[n] - labeur [n.m]
terrazza	[n] - terrasse [n]
terremoto	[n] - séisme [n.f]
terremoto	[n] - tremblement de terre [n]
territoriale	[adj] - territorial [adj.f]
territorio	[n] - territoire [n]
terrorismo	[n] - terrorisme [n]
terrorista	[adj] - terroriste [adj]
terzo	[adj] - troisième [adj.mf]
tesi	[n.f.sp] - thèse [n.f.ND]
tessile	[adj] - textile [adj]
tessuto	[n] - tissu [n]
testa	[n] - tête [n]
testamento	[n] - testament [n]
testare	[vblex] - tester [vblex]
testimoniare	[vblex] - attester [vblex]
testo	[n] - texte [n]
testuale	[adj] - textuel [adj.f]
tetto	[n] - plafond [n]
ti	[prn.pro] - te [prn]
tiger	[n] - tigre [n]
timidamente	[adv] - timidement [adv]
timido	[adj] - timide [adj.mf]
timo	[n] - thymus [n.m.sp]
timpano	[n] - tympan [n]
tipicamente	[adv] - typiquement [adv]
tipo	[n] - sorte [n.f]
tirare	[vblex] - jeter [vblex]
tiro	[n] - tir [n]
titolazione	[n] - diplôme [n.m]
titolazione	[n] - estimation [n]
titolo	[n] - licence [n]
titulo	[n] - titre [n]
toccare	[vblex] - toucher [vblex]
toga	[n] - toge [n]
tollerare	[vblex] - tolérer [vblex]
tonfano	[n] - bassin [n]
tonfano	[n] - marais [n.m.sp]
tonnellata	[n] - tonne [n]
tono	[n] - ton [n]
tonto	[adj] - bête [adj.mf]
topico	[adj] - cliché [n]
topico	[n] - cliché [n]
topografia	[n] - terrain [n]
torcere	[vblex] - corder [vblex]
tornare	[vblex] - retourner [vblex]
tornare	[vblex] - revenir [vblex]
torneo	[n] - tournoi [n]
toro	[n] - taureau [n]
torre	[n] - tour [n.f]
torrente	[n] - ruisseau [n]
torrone	[n] - nougat [n]
torta	[n] - gâteau [n]
tortura	[n] - torture [n]
torturare	[vblex] - torturer [vblex]
tosse	[n] - toux [n.f.sp]
tossicodipendenza	[n] - toxicomane [n.mf]
tostare	[vblex] - griller [vblex]
totale	[adj] - total [adj.f]
totalmente	[adv] - entièrement [adv]
totocalcio	[n] - loto sportif [n.m]
tra	[pr] - entre [pr]
tra poco	[adv] - dans peu de temps [adv]
traccia	[n.f] - trace [n.f]
traccia	[n.f] - vestige [n]
tradizionale	[adj] - traditionnel [adj.f]
tradizionalmente	[adv] - traditionnellement [adv]
tradizione	[n] - tradition [n]
tradurre	[vblex] - traduire [vblex]
traduttore	[n] - traducteur [n]
traduzione	[n] - traduction [n]
trafficante	[n.m] - trafiquant [n.f]
traffico	[n] - trafic [n]
traffico di droga	[n] - trafic de stupéfiants [n]
tragedia	[n] - tragédie [n]
traiettoria	[n] - trajectoire [n]
tram	[n] - tramway [n]
trama	[n] - trame [n]
tramite	[pr] - par l'intermédiaire de [pr]
tranne	[pr] - hormis [adv]
tranquillamente	[adv] - tranquillement [adv]
transatlantico	[adj] - transatlantique [adj.mf]
transitoriamente	[adv] - transitoirement [adv]
transitorio	[adj] - transitoire [adj.mf]
transizione	[n] - transition [n]
trapano	[n] - perce [n.f]
trapianto	[n] - greffe [n.f]
trappola	[n] - piège [n.m]
trasferimento	[n.m] - aliénation [n]
trasferimento	[n.m] - cession [n]
trasferimento	[n.m] - virement [n.m]
trasformare	[vblex] - transformer [vblex]
trasformazione	[n] - transformation [n]
trasfusione	[n] - transfusion [n]
trasmettere	[vblex] - transmettre [vblex]
trasparente	[adj] - transparent [adj.f]
trasportare	[vblex] - voiturer [vblex]
trasporti	[n] - transport [n]
trattamento	[n] - traitement [n]
trattativa	[n.f] - concert [n]
trattore	[n] - tracteur [n]
trauma	[n] - trauma [n]
traumatologia	[n] - traumatologie [n]
trave	[n] - poutre [n]
trazo	[n] - trait [n]
tre	[num] - trois [num]
tremendamente	[adv] - terriblement [adv]
treno	[n] - train [n]
triangolo	[n] - triangle [n]
tribunale	[n] - tribunal [n]
tributare	[vblex] - payer des impôts [vblex]
tributario	[n] - fiscal [adj.f]
tributo	[n] - tribut [n]
tribù	[n] - tribu [n]
trilogia	[n] - trilogie [n]
trimestrale	[adj] - trimestriel [adj.f]
trio	[n] - trio [n]
trionfale	[adj] - triomphal [adj.f]
trionfare	[vblex] - triompher [vblex]
triplicare	[vblex] - tripler [vblex]
triviale	[adj] - trivial [adj.f]
trofeo	[n] - trophée [n]
tronco	[n] - tronc [n]
tropicale	[adj] - tropical [adj.f]
troppo	[adv] - trop [adv]
trovare	[vblex] - rencontrer [vblex]
trovare	[vblex] - trouver [vblex]
tu	[prn.tn] - toi [prn]
tumor	[n] - tumeur [n.f]
tunica	[n] - tunique [n]
tunnel	[n] - tunnel [n]
tuo	[det.pos.f] - à toi [adj.pos.mf.sp]
tuo	[det.pos.m] - à toi [adj.pos.mf.sp]
turco	[adj] - turc [adj]
turismo	[n] - tourisme [n]
turista	[n.f.pl] - touriste [n]
turista	[n.GD.pl] - touriste [n]
turista	[n.m.pl] - touriste [n]
turista	[n.mf.sg] - touriste [n]
turno	[n] - tour [n]
turpiloquio	[n] - grossièreté [n]
tutelare	[vblex] - protéger [vblex]
tutore	[n] - tuteur [n]
tuttavia	[adv] - en revanche [adv]
tutti e due	[prn] - les deux [det]
tutti quanti	[prn] - tout le monde [prn]
tutto	[det] - tout [predet]
tutto	[prn] - tout [predet]
tè	[n] - thé [n]
ubicare	[vblex] - placer [vblex]
ubriaco	[adj] - ivrogne [n.mf]
ubriaco	[n] - ivrogne [n.mf]
uccello	[n] - oiseau [n.m]
uccello	[n] - oiseau [n]
uccidere	[vblex] - assommer [vblex]
ufficiale	[adj] - officiel [adj.f]
ufficiale	[n] - officiel [adj.f]
ufficialmente	[adv] - officiellement [adv]
ufficio	[n.m] - bureau [n.m]
uguale	[adj] - égal [adj.f]
uguale	[adv] - égal [adj.f]
ulteriormente	[adv] - additionnellement [adv]
ultimamente	[adv] - dernièrement [adv]
ultimo	[adj] - ultime [adj.mf]
umanitario	[adj] - humanitaire [adj.mf]
umanità	[n.f.sp] - humanité [n]
umano	[adj] - humain [adj]
umidità	[n.f.sp] - humidité [n]
umiliare	[vblex] - humilier [vblex]
umiliazione	[n] - humiliation [n]
umilmente	[adv] - humblement [adv]
umiltà	[n.f.sp] - humilité [n]
umorismo	[n] - humeur [n.f]
umorista	[n] - humoriste [n]
un	[det.ind.f] - un [det.ind.mf.pl]
un	[det.ind.mf] - un [det.ind.mf.pl]
un	[det.ind.m] - un [det.ind.mf.pl]
un altro	[det.ind] - autre [adj.mf]
una volta che	[adv] - une fois [adv]
unanime	[adj] - unanime [adj]
undicesimo	[adj] - onzième [adj.mf]
ungherese	[adj] - hongrois [adj.f]
unghia	[n] - ongle [n.m]
unicamente	[adv] - uniquement [adv]
unico	[adj] - unique [adj.mf]
unicorno	[n] - licorne [n.f]
unidirezionale	[adj] - unidirectionnel [adj.f]
unificare	[vblex] - unifier [vblex]
unilaterale	[adj] - unilatéral [adj.f]
unilateralmente	[adv] - unilatéralement [adv]
unione	[n.f] - union [n]
unire	[vblex] - unir [vblex]
unità	[n.f.sp] - unité [n]
universale	[adj] - universel [adj.f]
universitario	[adj] - universitaire [adj.mf]
università	[n.f.sp] - université [n]
universo	[n] - univers [n.m.sp]
uno	[num] - un [det.ind.mf.pl]
uno	[prn.tn.f.sg] - un [det.ind.mf.pl]
uno	[prn.tn.m.sg] - un [det.ind.mf.pl]
uomo	[n] - homme [n]
uomo	[n] - mâle [n]
uovo	[n.f] - oeuf [n]
uovo	[n] - oeuf [n]
uragano	[n] - ouragan [n]
uranio	[n] - uranium [n]
urbanisticamente	[adv] - urbanistiquement [adv]
urbano	[adj] - urbain [adj]
urgente	[adj] - pressant [adj.f]
urgentemente	[adv] - urgentement [adv]
urina	[n] - urine [n]
urlo	[n] - cri [n]
ursidae	[n] - ours [n.f]
usare	[vblex] - user [vblex]
uscire	[vblex] - sortir [vblex]
usignolo	[n] - rossignol [n]
ustione	[n] - brûlure [n]
utensile	[n] - outil [n.m]
utente	[n.mf] - utilisateur [n]
utero	[n] - utérus [n.m.sp]
utile	[adj] - utile [adj]
utile	[n] - bénéfice [n.f]
utile	[n] - gain [n.m]
utopia	[n] - utopie [n]
v	[n] - v [n.m]
vacante	[adj] - vacant [adj.f]
vaccino	[n.m] - vaccin [n.m]
vaccino	[n] - vaccin [n.m]
vaccino	[n] - vaccination [n]
vagina	[n] - vagin [n.m]
valanga	[n.f] - avalanche [n.f]
valanga	[n] - avalanche [n.f]
valencia	[n] - valence [n]
valenziano	[adj] - valencien [adj]
valere	[vblex] - valoir [vblex]
validare	[vblex] - valider [vblex]
valigia	[n] - valise [n]
valle	[n.f] - vallée [n.f]
valore	[n] - montant [n]
valore	[n] - valeur [n.f]
valore aggiunto	[n] - plus-value [n]
valutazione	[n] - évaluation [n]
valvola	[n] - soupape [n]
vampiro	[n] - vampire [n]
vandalismo	[n] - vandalisme [n]
vanità	[n.f.sp] - vanité [n]
vano	[adj] - vain [adj]
vantaggioso	[adj] - avantageux [adj.f]
vapore	[n] - vapeur [n.f]
variabile	[n] - variable [adj]
variabilità	[n.f.sp] - variabilité [n]
variare	[vblex] - varier [vblex]
vario	[det] - divers [adj.f]
vasca	[n] - baignoire [n]
vasellame	[n.m] - vaisselle [n]
vaso	[n] - pichet [n]
vassoio	[n.m] - plate [n]
vecchio	[adj] - vieux [adj.f]
vedere	[n] - voir [vblex]
vedere	[vblex] - voir [vblex]
vedovo	[adj] - veuf [adj]
vegetale	[adj] - végétal [adj.f]
veleno	[n] - poison [n]
velivolo	[n] - aéronef [n.m]
veloce	[adj] - rapide [adj.mf]
velocità	[n.f.sp] - vitesse [n]
vena	[n] - veine [n]
vendere	[vblex] - débiter [vblex]
venerdì	[n] - vendredi [n.m.ND]
venezuela	[n] - vénézuélien [adj]
venire	[vblex] - venir [vblex]
ventaglio	[n] - ventilateur [n]
ventaglio	[n] - éventail [n]
ventesimo	[adj] - vingtième [adj.mf]
ventilazione	[n] - ventilation [n]
vento	[n] - vent [n]
veramente	[adv] - authentiquement [adv]
veramente	[adv] - véritablement [adv]
verbale	[adj] - verbal [adj.f]
verbalmente	[adv] - verbalement [adv]
verbo	[n] - verbe [n]
verde	[n] - vert [adj.f]
verdura	[n] - légume [n.m]
vergine	[adj] - vierge [adj]
verginità	[n.f.sp] - virginité [n]
verificare	[vblex] - vérifier [vblex]
verità	[n.f.sp] - vraiment [adv]
vernice	[n] - peinture [n]
versare	[vblex] - traiter [vblex]
versatile	[adj] - versatile [adj]
versione	[n] - version [n]
verso	[n] - vers [n.m.sp]
verso	[pr] - envers [pr]
vertebra	[n] - vertèbre [n]
verticale	[adj] - vertical [adj.f]
verticalmente	[adv] - verticalement [adv]
vertice	[n.m] - cime [n.f]
vertice	[n] - cime [n.f]
vescica	[n] - ampoule [n]
vescovo	[n] - évêque [n]
veste	[n] - apparence [n]
veste	[n] - forme [n.f]
vestiario	[n] - garde-robe [n.f]
vestire	[vblex] - affubler [vblex]
vestito	[n] - robe [n.f]
veterinario	[adj] - vétérinaire [adj.mf]
vetrina	[n] - vitrine [n]
vetro	[n] - verre [n]
vettore	[n.m] - compagnie [n]
vi	[prn.pro] - vous [prn]
viadotto	[n] - viaduc [n]
viario	[adj] - routier [adj.f]
viario	[adj] - routier [adj]
vibrante	[adj] - vibrant [adj.f]
vibrare	[vblex] - vibrer [vblex]
vibrazione	[n] - vibration [n]
viceversa	[adv] - vice versa [adv]
vicia faba	[n] - fève [n]
vicinato	[n.m] - voisinage [n.m]
vicini	[adv] - ensemble [adv]
vicino	[adj] - voisin [adj]
vicino	[adv] - auprès [adv]
vicino a	[pr] - près [pr]
video	[n] - vidéo [n.f]
videogioco	[n] - jeu vidéo [n]
vigente	[adj] - en vigueur [adj.mf.sp]
vigilare	[vblex] - surveiller [vblex]
vigile-del-fuoco	[n] - pompier [n]
vigneto	[n] - vignoble [n]
vignetta	[n] - vignette [n]
vigore	[n] - vigueur [n]
villa	[n] - bourg [n.m]
villaggio	[n] - bourgade [n]
vincere	[vblex] - gagner [vblex]
vincere	[vblex] - vaincre [vblex]
vino	[n] - vin [n]
violare	[vblex] - violer [vblex]
violentare	[vblex] - violer [vblex]
violentemente	[adv] - violemment [adv]
violento	[adj] - violent [adj]
violenza	[n] - violence [n]
violino	[n] - violon [n]
virale	[adj] - viral [adj.f]
virile	[adj] - mâle [adj]
virtuale	[adj] - virtuel [adj.f]
virtualmente	[adv] - virtuellement [adv]
virtuoso	[adj] - vertueux [adj.f]
virtù	[n] - vertu [n]
virus	[n] - virus [n]
viscerale	[adj] - viscéral [adj.f]
visibile	[adj] - visible [adj]
visibilità	[n.f.sp] - visibilité [n]
visibilmente	[adv] - visiblement [adv]
visita	[n.f] - reconnaissance [n.f]
visitare	[vblex] - rendre visite [vblex]
visitatore	[n.mf] - visiteur [adj.f]
visivamente	[adv] - visuellement [adv]
viso	[n] - visage [n.m]
viso	[n] - visage [n]
visuale	[adj] - visuel [adj.f]
visualizzare	[vblex] - visualiser [vblex]
vita	[n] - vie [n]
vitale	[adj] - vital [adj.f]
vitamine	[n] - vitamine [n]
vitis	[n] - raisin [n.m]
vittima	[n] - victime [n]
vittoria	[n] - victoire [n]
viveiro	[n] - pépinière [n.f]
vivere	[vblex] - habiter [vblex]
viziare	[vblex] - consentir [vblex]
vocale	[adj] - vocal [adj.f]
vocale	[n] - vocal [adj.f]
vocazione	[n] - vocation [n]
voce	[n] - voix [n.f.sp]
vodka	[n] - vodka [n.f]
voglia	[n] - appétit [n.m]
voi	[prn.tn.p2.mf] - vous [prn.tn.p2.mf]
volante	[adj.mf] - volant [adj]
volante	[n] - volant [adj.GD]
volare	[vblex] - envoler [vblex]
volatile	[adj] - oiseau [n.m]
volatile	[n.m] - oiseau [n.m]
volatile	[n] - oiseau [n.m]
volere	[vblex] - avoir envie de [vblex]
volgare	[adj] - vulgaire [adj]
volo	[n] - vol [n]
volontariamente	[adv] - volontairement [adv]
volontariato	[n] - volontariat [n]
volontario	[adj] - volontaire [adj.mf]
volontà	[n.f.sp] - volonté [n]
volpe	[n] - renard [n.m]
volta	[n] - fois [n.f.sp]
volta	[n] - tour [n.m]
volume	[n] - volume [n]
voluntà	[n.f.sp] - volonté [n]
vomitare	[vblex] - vomir [vblex]
vomito	[n] - vomissement [n]
vostro	[adj.pos] - à vous [adj.pos.mf.sp]
vostro	[det.pos] - à vous [adj.pos.mf.sp]
votare	[vblex] - voter [vblex]
voto	[n] - voeu [n]
vulcanico	[adj] - volcanique [adj.mf]
vulcano	[n] - volcan [n]
vulnerabile	[adj] - vulnérable [adj]
vuoto	[n] - vide [adj.mf]
w	[n] - w [n.m]
watt	[n] - watt [n]
web	[n] - web [n.m]
wolf	[n] - loup [n.m]
x	[n] - x [n.m]
xenofobia	[n] - xénophobie [n]
yogurt	[n] - yaourt [n]
zanzara	[n] - moustique [n]
zarzuela	[n] - zarzuela [n]
zavorra	[n.f] - lest [n]
zebra	[n] - zèbre [n]
zero	[num] - zéro [num]
zero	[n] - zéro [num]
zinco	[n] - zinc [n]
zona	[n.f] - cadre [n]
zona	[n.f] - zone [n]
zoofilia	[n] - bestialité [n]
zucchero	[n] - sucre [n]
